DATE,COVID_DEATHS,DAILY_DELTA_DEATHS,DAILY_BASE_DEATHS,COVID_COUNT,DAILY_DELTA_CASES,DAILY_BASE_CASES,COVID_COUNT_CUMSUM,COVID_DEATHS_CUMSUM,COVID_COUNT_BY_SPECIMEN_COLLECTION_DATE
2020-02-26,0,0,0,3,0,3,3,0,3
2020-02-27,0,0,0,0,0,0,3,0,0
2020-02-28,0,0,0,0,0,0,3,0,0
2020-02-29,0,0,0,1,0,1,4,0,1
2020-03-01,0,0,0,0,0,0,4,0,0
2020-03-02,0,0,0,0,0,0,4,0,0
2020-03-03,0,0,0,0,0,0,4,0,0
2020-03-04,0,0,0,0,0,0,4,0,0
2020-03-05,0,0,0,0,0,0,4,0,0
2020-03-06,0,0,0,1,0,1,5,0,1
2020-03-07,0,0,0,1,0,1,6,0,1
2020-03-08,0,0,0,2,0,2,8,0,2
2020-03-09,0,0,0,7,0,7,15,0,7
2020-03-10,0,0,0,1,0,1,16,0,1
2020-03-11,0,0,0,7,0,7,23,0,7
2020-03-12,0,0,0,17,0,17,40,0,17
2020-03-13,0,0,0,22,0,22,62,0,22
2020-03-14,0,0,0,28,0,28,90,0,28
2020-03-15,0,0,0,23,0,23,113,0,23
2020-03-16,1,0,1,84,0,84,197,1,84
2020-03-17,2,0,2,93,0,93,290,3,93
2020-03-18,1,0,1,115,0,115,405,4,115
2020-03-19,0,0,0,142,0,142,547,4,142
2020-03-20,6,0,6,217,0,217,764,10,217
2020-03-21,4,0,4,125,0,125,889,14,125
2020-03-22,4,0,4,120,0,120,1009,18,120
2020-03-23,5,0,5,314,0,314,1323,23,314
2020-03-24,5,0,5,367,0,367,1690,28,367
2020-03-25,5,0,5,382,0,382,2072,33,382
2020-03-26,9,0,9,411,0,411,2483,42,411
2020-03-27,3,0,3,437,0,437,2920,45,438
2020-03-28,13,0,13,309,0,309,3229,58,308
2020-03-29,17,0,17,265,0,265,3494,75,265
2020-03-30,14,0,14,443,0,443,3937,89,443
2020-03-31,23,0,23,483,0,483,4420,112,484
2020-04-01,21,0,21,444,0,444,4864,133,443
2020-04-02,21,0,21,485,0,485,5349,154,486
2020-04-03,32,0,32,442,0,442,5791,186,441
2020-04-04,25,0,25,293,0,293,6084,211,293
2020-04-05,32,0,32,248,0,248,6332,243,248
2020-04-06,25,0,25,540,0,540,6872,268,540
2020-04-07,38,0,38,546,0,546,7418,306,546
2020-04-08,29,0,29,564,0,564,7982,335,564
2020-04-09,36,0,36,426,0,426,8408,371,427
2020-04-10,26,0,26,458,0,458,8866,397,457
2020-04-11,23,0,23,263,0,263,9129,420,263
2020-04-12,27,0,27,171,0,171,9300,447,171
2020-04-13,35,0,35,614,0,614,9914,482,614
2020-04-14,47,0,47,632,0,632,10546,529,632
2020-04-15,38,0,38,576,0,576,11122,567,576
2020-04-16,34,0,34,616,0,616,11738,601,616
2020-04-17,35,0,35,650,0,650,12388,636,650
2020-04-18,28,0,28,283,0,283,12671,664,283
2020-04-19,39,0,39,257,0,257,12928,703,257
2020-04-20,37,0,37,729,0,729,13657,740,729
2020-04-21,49,0,49,648,0,648,14305,789,648
2020-04-22,50,0,50,605,0,605,14910,839,605
2020-04-23,38,0,38,1426,0,1426,16336,877,1426
2020-04-24,36,0,36,802,0,802,17138,913,802
2020-04-25,42,0,42,378,0,378,17516,955,378
2020-04-26,35,0,35,232,0,232,17748,990,232
2020-04-27,44,0,44,717,0,717,18465,1034,717
2020-04-28,36,0,36,750,0,750,19215,1070,750
2020-04-29,44,0,44,702,0,702,19917,1114,702
2020-04-30,45,0,45,680,0,680,20597,1159,680
2020-05-01,37,0,37,872,0,872,21469,1196,872
2020-05-02,44,0,44,441,0,441,21910,1240,441
2020-05-03,37,0,37,308,0,308,22218,1277,309
2020-05-04,40,0,40,698,0,698,22916,1317,697
2020-05-05,37,0,37,753,0,753,23669,1354,753
2020-05-06,42,0,42,539,0,539,24208,1396,539
2020-05-07,37,0,37,619,0,619,24827,1433,620
2020-05-08,28,0,28,565,0,565,25392,1461,564
2020-05-09,34,0,34,313,0,313,25705,1495,313
2020-05-10,33,0,33,142,0,142,25847,1528,142
2020-05-11,41,0,41,621,0,621,26468,1569,621
2020-05-12,38,0,38,698,0,698,27166,1607,698
2020-05-13,27,0,27,593,0,593,27759,1634,593
2020-05-14,44,0,44,524,0,524,28283,1678,524
2020-05-15,33,0,33,867,0,867,29150,1711,867
2020-05-16,30,0,30,245,0,245,29395,1741,245
2020-05-17,30,0,30,196,0,196,29591,1771,196
2020-05-18,41,0,41,699,0,699,30290,1812,699
2020-05-19,31,0,31,590,0,590,30880,1843,591
2020-05-20,33,0,33,579,0,579,31459,1876,578
2020-05-21,39,0,39,651,0,651,32110,1915,651
2020-05-22,18,0,18,542,0,542,32652,1933,542
2020-05-23,25,0,25,209,0,209,32861,1958,209
2020-05-24,15,0,15,157,0,157,33018,1973,157
2020-05-25,23,0,23,175,0,175,33193,1996,175
2020-05-26,21,0,21,655,0,655,33848,2017,655
2020-05-27,15,0,15,453,0,453,34301,2032,453
2020-05-28,19,0,19,496,0,496,34797,2051,496
2020-05-29,22,0,22,478,0,478,35275,2073,478
2020-05-30,23,0,23,183,0,183,35458,2096,183
2020-05-31,17,0,17,134,0,134,35592,2113,134
2020-06-01,19,0,19,611,0,611,36203,2132,611
2020-06-02,21,0,21,426,0,426,36629,2153,426
2020-06-03,28,0,28,408,0,408,37037,2181,408
2020-06-04,23,0,23,462,0,462,37499,2204,462
2020-06-05,21,0,21,433,0,433,37932,2225,434
2020-06-06,10,0,10,158,0,158,38090,2235,157
2020-06-07,14,0,14,154,0,154,38244,2249,154
2020-06-08,16,0,16,688,0,688,38932,2265,688
2020-06-09,26,0,26,455,0,455,39387,2291,455
2020-06-10,18,0,18,456,0,456,39843,2309,456
2020-06-11,15,0,15,402,0,402,40245,2324,402
2020-06-12,16,0,16,380,0,380,40625,2340,380
2020-06-13,13,0,13,168,0,168,40793,2353,168
2020-06-14,20,0,20,175,0,175,40968,2373,175
2020-06-15,15,0,15,469,0,469,41437,2388,469
2020-06-16,15,0,15,370,0,370,41807,2403,370
2020-06-17,18,0,18,429,0,429,42236,2421,429
2020-06-18,26,0,26,394,0,394,42630,2447,394
2020-06-19,11,0,11,366,0,366,42996,2458,366
2020-06-20,10,0,10,206,0,206,43202,2468,206
2020-06-21,12,0,12,134,0,134,43336,2480,134
2020-06-22,16,0,16,596,0,596,43932,2496,596
2020-06-23,5,0,5,480,0,480,44412,2501,480
2020-06-24,10,0,10,457,0,457,44869,2511,457
2020-06-25,12,0,12,466,0,466,45335,2523,466
2020-06-26,12,0,12,544,0,544,45879,2535,544
2020-06-27,12,0,12,254,0,254,46133,2547,254
2020-06-28,9,0,9,218,0,218,46351,2556,218
2020-06-29,8,0,8,640,0,640,46991,2564,640
2020-06-30,10,0,10,592,0,592,47583,2574,592
2020-07-01,12,0,12,567,0,567,48150,2586,567
2020-07-02,9,0,9,667,0,667,48817,2595,667
2020-07-03,11,0,11,325,0,325,49142,2606,325
2020-07-04,7,0,7,174,0,174,49316,2613,174
2020-07-05,12,0,12,275,0,275,49591,2625,275
2020-07-06,16,0,16,913,0,913,50504,2641,913
2020-07-07,9,0,9,841,0,841,51345,2650,841
2020-07-08,8,0,8,735,0,735,52080,2658,735
2020-07-09,11,0,11,746,0,746,52826,2669,746
2020-07-10,7,0,7,746,0,746,53572,2676,747
2020-07-11,11,0,11,370,0,370,53942,2687,369
2020-07-12,12,0,12,335,0,335,54277,2699,335
2020-07-13,9,0,9,1022,0,1022,55299,2708,1022
2020-07-14,6,0,6,946,0,946,56245,2714,946
2020-07-15,11,0,11,892,0,892,57137,2725,892
2020-07-16,10,0,10,988,0,988,58125,2735,988
2020-07-17,9,0,9,954,0,954,59079,2744,954
2020-07-18,9,0,9,377,0,377,59456,2753,377
2020-07-19,10,0,10,299,0,299,59755,2763,299
2020-07-20,14,0,14,1031,0,1031,60786,2777,1031
2020-07-21,9,0,9,977,0,977,61763,2786,977
2020-07-22,13,0,13,981,0,981,62744,2799,981
2020-07-23,10,0,10,999,0,999,63743,2809,999
2020-07-24,11,0,11,906,0,906,64649,2820,906
2020-07-25,11,0,11,399,0,399,65048,2831,399
2020-07-26,10,0,10,280,0,280,65328,2841,280
2020-07-27,4,0,4,1050,0,1050,66378,2845,1050
2020-07-28,6,0,6,964,0,964,67342,2851,964
2020-07-29,21,0,21,1053,0,1053,68395,2872,1053
2020-07-30,9,0,9,842,0,842,69237,2881,842
2020-07-31,11,0,11,957,0,957,70194,2892,957
2020-08-01,13,0,13,424,0,424,70618,2905,424
2020-08-02,9,0,9,300,0,300,70918,2914,300
2020-08-03,9,0,9,1189,0,1189,72107,2923,1189
2020-08-04,11,0,11,1127,0,1127,73234,2934,1127
2020-08-05,5,0,5,1081,0,1081,74315,2939,1081
2020-08-06,15,0,15,1069,0,1069,75384,2954,1069
2020-08-07,14,0,14,1063,0,1063,76447,2968,1063
2020-08-08,12,0,12,408,0,408,76855,2980,408
2020-08-09,7,0,7,320,0,320,77175,2987,320
2020-08-10,16,0,16,1324,0,1324,78499,3003,1324
2020-08-11,13,0,13,1021,0,1021,79520,3016,1021
2020-08-12,15,0,15,1114,0,1114,80634,3031,1114
2020-08-13,14,0,14,933,0,933,81567,3045,933
2020-08-14,17,0,17,1071,0,1071,82638,3062,1071
2020-08-15,12,0,12,394,0,394,83032,3074,394
2020-08-16,12,0,12,342,0,342,83374,3086,342
2020-08-17,22,0,22,1271,0,1271,84645,3108,1271
2020-08-18,5,0,5,1156,0,1156,85801,3113,1156
2020-08-19,17,0,17,1110,0,1110,86911,3130,1110
2020-08-20,16,0,16,989,0,989,87900,3146,989
2020-08-21,8,0,8,970,0,970,88870,3154,970
2020-08-22,15,0,15,440,0,440,89310,3169,440
2020-08-23,12,0,12,363,0,363,89673,3181,363
2020-08-24,14,0,14,1273,0,1273,90946,3195,1274
2020-08-25,11,0,11,1123,0,1123,92069,3206,1122
2020-08-26,4,0,4,1200,0,1200,93269,3210,1200
2020-08-27,16,0,16,1076,0,1076,94345,3226,1076
2020-08-28,9,0,9,1017,0,1017,95362,3235,1017
2020-08-29,12,0,12,478,0,478,95840,3247,478
2020-08-30,9,0,9,324,0,324,96164,3256,324
2020-08-31,13,0,13,1349,0,1349,97513,3269,1349
2020-09-01,7,0,7,1081,0,1081,98594,3276,1081
2020-09-02,10,0,10,1104,0,1104,99698,3286,1104
2020-09-03,6,0,6,1069,0,1069,100767,3292,1069
2020-09-04,14,0,14,963,0,963,101730,3306,963
2020-09-05,11,0,11,438,0,438,102168,3317,438
2020-09-06,14,0,14,284,0,284,102452,3331,284
2020-09-07,11,0,11,369,0,369,102821,3342,369
2020-09-08,16,0,16,1358,0,1358,104179,3358,1358
2020-09-09,13,0,13,1063,0,1063,105242,3371,1063
2020-09-10,12,0,12,988,0,988,106230,3383,988
2020-09-11,12,0,12,994,0,994,107224,3395,994
2020-09-12,4,0,4,356,0,356,107580,3399,356
2020-09-13,17,0,17,301,0,301,107881,3416,301
2020-09-14,14,0,14,1212,0,1212,109093,3430,1212
2020-09-15,12,0,12,1013,0,1013,110106,3442,1013
2020-09-16,8,0,8,919,0,919,111025,3450,919
2020-09-17,15,0,15,854,0,854,111879,3465,854
2020-09-18,12,0,12,799,0,799,112678,3477,799
2020-09-19,10,0,10,382,0,382,113060,3487,382
2020-09-20,7,0,7,290,0,290,113350,3494,290
2020-09-21,11,0,11,1209,0,1209,114559,3505,1209
2020-09-22,15,0,15,1157,0,1157,115716,3520,1157
2020-09-23,17,0,17,1155,0,1155,116871,3537,1155
2020-09-24,13,0,13,1095,0,1095,117966,3550,1095
2020-09-25,13,0,13,991,0,991,118957,3563,991
2020-09-26,24,0,24,513,0,513,119470,3587,513
2020-09-27,12,0,12,430,0,430,119900,3599,430
2020-09-28,20,0,20,1744,0,1744,121644,3619,1744
2020-09-29,19,0,19,1483,0,1483,123127,3638,1483
2020-09-30,13,0,13,1330,0,1330,124457,3651,1330
2020-10-01,19,0,19,1313,0,1313,125770,3670,1314
2020-10-02,19,0,19,1295,0,1295,127065,3689,1294
2020-10-03,24,0,24,611,0,611,127676,3713,611
2020-10-04,16,0,16,566,0,566,128242,3729,567
2020-10-05,14,0,14,2049,0,2049,130291,3743,2049
2020-10-06,15,0,15,1791,0,1791,132082,3758,1790
2020-10-07,19,0,19,1876,0,1876,133958,3777,1876
2020-10-08,23,0,23,1982,0,1982,135940,3800,1982
2020-10-09,25,0,25,1935,0,1935,137875,3825,1935
2020-10-10,17,0,17,952,0,952,138827,3842,952
2020-10-11,21,0,21,774,0,774,139601,3863,774
2020-10-12,23,0,23,2517,0,2517,142118,3886,2517
2020-10-13,29,0,29,2482,0,2482,144600,3915,2482
2020-10-14,20,0,20,2272,0,2272,146872,3935,2272
2020-10-15,35,0,35,2211,0,2211,149083,3970,2211
2020-10-16,42,0,42,2034,0,2034,151117,4012,2035
2020-10-17,24,0,24,1053,0,1053,152170,4036,1052
2020-10-18,30,0,30,809,0,809,152979,4066,809
2020-10-19,20,0,20,3264,0,3264,156243,4086,3265
2020-10-20,36,0,36,2775,0,2775,159018,4122,2774
2020-10-21,33,0,33,2794,0,2794,161812,4155,2795
2020-10-22,36,0,36,2936,0,2936,164748,4191,2935
2020-10-23,28,0,28,2742,0,2742,167490,4219,2742
2020-10-24,25,0,25,1460,0,1460,168950,4244,1461
2020-10-25,30,0,30,1087,0,1087,170037,4274,1086
2020-10-26,41,0,41,4337,0,4337,174374,4315,4337
2020-10-27,41,0,41,3656,0,3656,178030,4356,3656
2020-10-28,35,0,35,3726,0,3726,181756,4391,3726
2020-10-29,39,0,39,3952,0,3952,185708,4430,3952
2020-10-30,50,0,50,3553,0,3553,189261,4480,3553
2020-10-31,35,0,35,1828,0,1828,191089,4515,1829
2020-11-01,40,0,40,1612,0,1612,192701,4555,1611
2020-11-02,43,0,43,5539,0,5539,198240,4598,5539
2020-11-03,42,0,42,5179,0,5179,203419,4640,5179
2020-11-04,52,0,52,6120,0,6120,209539,4692,6120
2020-11-05,40,0,40,6541,0,6541,216080,4732,6541
2020-11-06,57,0,57,6014,0,6014,222094,4789,6014
2020-11-07,49,0,49,3254,0,3254,225348,4838,3255
2020-11-08,61,0,61,2453,0,2453,227801,4899,2452
2020-11-09,44,0,44,9151,0,9151,236952,4943,9151
2020-11-10,61,0,61,8904,0,8904,245856,5004,8905
2020-11-11,59,0,59,6678,0,6678,252534,5063,6677
2020-11-12,41,0,41,8068,0,8068,260602,5104,8069
2020-11-13,46,0,46,6801,0,6801,267403,5150,6800
2020-11-14,52,0,52,3521,0,3521,270924,5202,3522
2020-11-15,70,0,70,2372,0,2372,273296,5272,2371
2020-11-16,62,0,62,9197,0,9197,282493,5334,9197
2020-11-17,83,0,83,8036,0,8036,290529,5417,8037
2020-11-18,74,0,74,7142,0,7142,297671,5491,7141
2020-11-19,78,0,78,7252,0,7252,304923,5569,7253
2020-11-20,72,0,72,6682,0,6682,311605,5641,6681
2020-11-21,69,0,69,3536,0,3536,315141,5710,3537
2020-11-22,78,0,78,2440,0,2440,317581,5788,2439
2020-11-23,88,0,88,8848,0,8848,326429,5876,8849
2020-11-24,82,0,82,7783,0,7783,334212,5958,7782
2020-11-25,84,0,84,6879,0,6879,341091,6042,6879
2020-11-26,95,0,95,1031,0,1031,342122,6137,1032
2020-11-27,86,0,86,5602,0,5602,347724,6223,5602
2020-11-28,73,0,73,3978,0,3978,351702,6296,3977
2020-11-29,81,0,81,2976,0,2976,354678,6377,2977
2020-11-30,84,0,84,10127,0,10127,364805,6461,10126
2020-12-01,87,0,87,8415,0,8415,373220,6548,8415
2020-12-02,100,0,100,7362,0,7362,380582,6648,7363
2020-12-03,90,0,90,7389,0,7389,387971,6738,7388
2020-12-04,99,0,99,6721,0,6721,394692,6837,6721
2020-12-05,97,0,97,3447,0,3447,398139,6934,3447
2020-12-06,90,0,90,2520,0,2520,400659,7024,2520
2020-12-07,95,0,95,9028,0,9028,409687,7119,9030
2020-12-08,111,0,111,7394,0,7394,417081,7230,7392
2020-12-09,105,0,105,6587,0,6587,423668,7335,6591
2020-12-10,108,0,108,6648,0,6648,430316,7443,6645
2020-12-11,110,0,110,5941,0,5941,436257,7553,5940
2020-12-12,97,0,97,3256,0,3256,439513,7650,3256
2020-12-13,87,0,87,2442,0,2442,441955,7737,2443
2020-12-14,107,0,107,8175,0,8175,450130,7844,8176
2020-12-15,95,0,95,6727,0,6727,456857,7939,6725
2020-12-16,94,0,94,5554,0,5554,462411,8033,5554
2020-12-17,115,0,115,5640,0,5640,468051,8148,5640
2020-12-18,110,0,110,5247,0,5247,473298,8258,5249
2020-12-19,96,0,96,3067,0,3067,476365,8354,3065
2020-12-20,88,0,88,2262,0,2262,478627,8442,2262
2020-12-21,107,0,107,7315,0,7315,485942,8549,7315
2020-12-22,84,0,84,5743,0,5743,491685,8633,5743
2020-12-23,94,0,94,5182,0,5182,496867,8727,5182
2020-12-24,79,0,79,3116,0,3116,499983,8806,3116
2020-12-25,91,0,91,612,0,612,500595,8897,612
2020-12-26,95,0,95,3767,0,3767,504362,8992,3767
2020-12-27,95,0,95,2802,0,2802,507164,9087,2803
2020-12-28,105,0,105,7917,0,7917,515081,9192,7918
2020-12-29,125,0,125,6617,0,6617,521698,9317,6617
2020-12-30,103,0,103,5915,0,5915,527613,9420,5914
2020-12-31,79,0,79,4885,0,4885,532498,9499,4885
2021-01-01,86,0,86,1234,0,1234,533732,9585,1238
2021-01-02,99,0,99,4666,0,4666,538398,9684,4665
2021-01-03,74,0,74,3028,0,3028,541426,9758,3031
2021-01-04,118,0,118,8641,0,8641,550067,9876,8653
2021-01-05,72,0,72,6585,0,6585,556652,9948,6569
2021-01-06,90,0,90,5473,0,5473,562125,10038,5487
2021-01-07,82,0,82,5255,0,5255,567380,10120,5242
2021-01-08,68,0,68,4450,0,4450,571830,10188,4451
2021-01-09,78,0,78,2706,0,2706,574536,10266,2701
2021-01-10,62,0,62,2198,0,2198,576734,10328,2202
2021-01-11,77,0,77,5551,0,5551,582285,10405,5549
2021-01-12,65,0,65,4439,0,4439,586724,10470,4437
2021-01-13,73,0,73,3838,0,3838,590562,10543,3839
2021-01-14,75,0,75,3815,0,3815,594377,10618,3814
2021-01-15,70,0,70,3267,0,3267,597644,10688,3267
2021-01-16,77,0,77,2041,0,2041,599685,10765,2041
2021-01-17,73,0,73,1718,0,1718,601403,10838,1718
2021-01-18,74,0,74,3731,0,3731,605134,10912,3732
2021-01-19,53,0,53,3577,0,3577,608711,10965,3576
2021-01-20,71,0,71,3130,0,3130,611841,11036,3130
2021-01-21,59,0,59,2956,0,2956,614797,11095,2956
2021-01-22,73,0,73,2674,0,2674,617471,11168,2674
2021-01-23,54,0,54,1551,0,1551,619022,11222,1551
2021-01-24,56,0,56,1224,0,1224,620246,11278,1225
2021-01-25,52,0,52,3261,0,3261,623507,11330,3260
2021-01-26,56,0,56,2490,0,2490,625997,11386,2491
2021-01-27,59,0,59,2286,0,2286,628283,11445,2285
2021-01-28,58,0,58,2179,0,2179,630462,11503,2180
2021-01-29,54,0,54,1996,0,1996,632458,11557,1995
2021-01-30,52,0,52,1161,0,1161,633619,11609,1162
2021-01-31,46,0,46,906,0,906,634525,11655,906
2021-02-01,49,0,49,2541,0,2541,637066,11704,2540
2021-02-02,54,0,54,2047,0,2047,639113,11758,2048
2021-02-03,53,0,53,1939,0,1939,641052,11811,1938
2021-02-04,43,0,43,1796,0,1796,642848,11854,1796
2021-02-05,32,0,32,1473,0,1473,644321,11886,1473
2021-02-06,29,0,29,981,0,981,645302,11915,981
2021-02-07,30,0,30,788,0,788,646090,11945,788
2021-02-08,26,0,26,1903,0,1903,647993,11971,1903
2021-02-09,36,0,36,1538,0,1538,649531,12007,1539
2021-02-10,31,0,31,1304,0,1304,650835,12038,1303
2021-02-11,21,0,21,1291,0,1291,652126,12059,1291
2021-02-12,29,0,29,1209,0,1209,653335,12088,1209
2021-02-13,21,0,21,707,0,707,654042,12109,707
2021-02-14,22,0,22,576,0,576,654618,12131,577
2021-02-15,31,0,31,1064,0,1064,655682,12162,1063
2021-02-16,25,0,25,699,0,699,656381,12187,699
2021-02-17,28,0,28,1283,0,1283,657664,12215,1283
2021-02-18,15,0,15,1109,0,1109,658773,12230,1111
2021-02-19,10,0,10,1005,0,1005,659778,12240,1004
2021-02-20,31,0,31,619,0,619,660397,12271,618
2021-02-21,21,0,21,535,0,535,660932,12292,535
2021-02-22,22,0,22,1267,0,1267,662199,12314,1268
2021-02-23,17,0,17,907,0,907,663106,12331,906
2021-02-24,19,0,19,932,0,932,664038,12350,932
2021-02-25,17,0,17,825,0,825,664863,12367,825
2021-02-26,15,0,15,743,0,743,665606,12382,743
2021-02-27,12,0,12,509,0,509,666115,12394,509
2021-02-28,16,0,16,406,0,406,666521,12410,406
2021-03-01,14,0,14,1008,0,1008,667529,12424,1008
2021-03-02,26,0,26,905,0,905,668434,12450,905
2021-03-03,11,0,11,827,0,827,669261,12461,827
2021-03-04,13,0,13,832,0,832,670093,12474,832
2021-03-05,17,0,17,763,0,763,670856,12491,763
2021-03-06,13,0,13,451,0,451,671307,12504,451
2021-03-07,13,0,13,424,0,424,671731,12517,424
2021-03-08,14,0,14,1072,0,1072,672803,12531,1072
2021-03-09,12,0,12,832,0,832,673635,12543,832
2021-03-10,16,0,16,885,0,885,674520,12559,885
2021-03-11,10,0,10,840,0,840,675360,12569,840
2021-03-12,15,0,15,773,0,773,676133,12584,773
2021-03-13,7,0,7,363,0,363,676496,12591,363
2021-03-14,7,0,7,473,0,473,676969,12598,474
2021-03-15,8,0,8,1137,0,1137,678106,12606,1136
2021-03-16,10,0,10,910,0,910,679016,12616,910
2021-03-17,8,0,8,860,0,860,679876,12624,860
2021-03-18,20,0,20,872,0,872,680748,12644,872
2021-03-19,9,0,9,847,0,847,681595,12653,847
2021-03-20,2,0,2,554,0,554,682149,12655,554
2021-03-21,10,0,10,492,0,492,682641,12665,492
2021-03-22,7,0,7,1197,0,1197,683838,12672,1197
2021-03-23,6,0,6,1064,0,1064,684902,12678,1064
2021-03-24,7,0,7,1067,0,1067,685969,12685,1067
2021-03-25,9,0,9,1012,0,1012,686981,12694,1012
2021-03-26,8,0,8,977,0,977,687958,12702,978
2021-03-27,8,0,8,642,0,642,688600,12710,641
2021-03-28,8,0,8,591,0,591,689191,12718,591
2021-03-29,5,0,5,1398,0,1398,690589,12723,1398
2021-03-30,10,0,10,1270,0,1270,691859,12733,1270
2021-03-31,10,0,10,1228,0,1228,693087,12743,1228
2021-04-01,9,0,9,1189,0,1189,694276,12752,1189
2021-04-02,6,0,6,1023,0,1023,695299,12758,1023
2021-04-03,7,0,7,713,0,713,696012,12765,713
2021-04-04,6,0,6,427,0,427,696439,12771,427
2021-04-05,4,0,4,1612,0,1612,698051,12775,1612
2021-04-06,5,0,5,1401,0,1401,699452,12780,1401
2021-04-07,9,0,9,1359,0,1359,700811,12789,1359
2021-04-08,7,0,7,1310,0,1310,702121,12796,1310
2021-04-09,9,0,9,1232,0,1232,703353,12805,1232
2021-04-10,8,0,8,789,0,789,704142,12813,789
2021-04-11,11,0,11,693,0,693,704835,12824,693
2021-04-12,11,0,11,1649,0,1649,706484,12835,1649
2021-04-13,16,0,16,1377,0,1377,707861,12851,1377
2021-04-14,4,0,4,1257,0,1257,709118,12855,1257
2021-04-15,6,0,6,1170,0,1170,710288,12861,1170
2021-04-16,12,0,12,1118,0,1118,711406,12873,1119
2021-04-17,7,0,7,665,0,665,712071,12880,664
2021-04-18,6,0,6,541,0,541,712612,12886,542
2021-04-19,6,0,6,1417,0,1417,714029,12892,1416
2021-04-20,7,0,7,1137,0,1137,715166,12899,1137
2021-04-21,8,0,8,1135,0,1135,716301,12907,1135
2021-04-22,4,0,4,1025,0,1025,717326,12911,1025
2021-04-23,6,0,6,1069,0,1069,718395,12917,1069
2021-04-24,9,0,9,634,0,634,719029,12926,634
2021-04-25,11,0,11,618,0,618,719647,12937,620
2021-04-26,8,0,8,1653,0,1653,721300,12945,1651
2021-04-27,10,0,10,1375,0,1375,722675,12955,1375
2021-04-28,9,0,9,1333,0,1333,724008,12964,1335
2021-04-29,8,0,8,1255,0,1255,725263,12972,1253
2021-04-30,10,0,10,1141,0,1141,726404,12982,1141
2021-05-01,7,0,7,651,0,651,727055,12989,651
2021-05-02,10,0,10,694,0,694,727749,12999,694
2021-05-03,7,0,7,1478,0,1478,729227,13006,1478
2021-05-04,7,0,7,1229,0,1229,730456,13013,1230
2021-05-05,11,0,11,1121,0,1121,731577,13024,1120
2021-05-06,10,0,10,984,0,984,732561,13034,984
2021-05-07,10,0,10,825,0,825,733386,13044,825
2021-05-08,9,0,9,572,0,572,733958,13053,572
2021-05-09,14,0,14,454,0,454,734412,13067,454
2021-05-10,5,0,5,1090,0,1090,735502,13072,1090
2021-05-11,10,0,10,886,0,886,736388,13082,886
2021-05-12,8,0,8,805,0,805,737193,13090,806
2021-05-13,12,0,12,789,0,789,737982,13102,789
2021-05-14,8,0,8,762,0,762,738744,13110,761
2021-05-15,11,0,11,447,0,447,739191,13121,447
2021-05-16,13,0,13,451,0,451,739642,13134,451
2021-05-17,8,0,8,1025,0,1025,740667,13142,1026
2021-05-18,5,0,5,850,0,850,741517,13147,849
2021-05-19,16,0,16,746,0,746,742263,13163,746
2021-05-20,9,0,9,671,0,671,742934,13172,671
2021-05-21,9,0,9,632,0,632,743566,13181,632
2021-05-22,13,0,13,366,0,366,743932,13194,366
2021-05-23,2,0,2,361,0,361,744293,13196,361
2021-05-24,9,0,9,729,0,729,745022,13205,730
2021-05-25,11,0,11,636,0,636,745658,13216,635
2021-05-26,12,0,12,505,0,505,746163,13228,505
2021-05-27,9,0,9,463,0,463,746626,13237,463
2021-05-28,11,0,11,386,0,386,747012,13248,386
2021-05-29,15,0,15,256,0,256,747268,13263,256
2021-05-30,8,0,8,229,0,229,747497,13271,229
2021-05-31,16,0,16,155,0,155,747652,13287,155
2021-06-01,8,0,8,536,0,536,748188,13295,536
2021-06-02,6,0,6,352,0,352,748540,13301,352
2021-06-03,10,0,10,383,0,383,748923,13311,383
2021-06-04,11,0,11,348,0,348,749271,13322,348
2021-06-05,7,0,7,216,0,216,749487,13329,217
2021-06-06,8,0,8,205,0,205,749692,13337,204
2021-06-07,6,0,6,357,0,357,750049,13343,357
2021-06-08,10,0,10,310,0,310,750359,13353,310
2021-06-09,6,0,6,300,0,300,750659,13359,300
2021-06-10,9,0,9,257,0,257,750916,13368,257
2021-06-11,7,0,7,232,0,232,751148,13375,232
2021-06-12,7,0,7,137,0,137,751285,13382,137
2021-06-13,8,0,8,134,0,134,751419,13390,134
2021-06-14,2,0,2,267,0,267,751686,13392,267
2021-06-15,8,0,8,236,0,236,751922,13400,236
2021-06-16,2,0,2,197,0,197,752119,13402,197
2021-06-17,10,0,10,203,0,203,752322,13412,203
2021-06-18,6,0,6,201,0,201,752523,13418,201
2021-06-19,4,0,4,123,0,123,752646,13422,123
2021-06-20,8,0,8,121,0,121,752767,13430,121
2021-06-21,4,0,4,264,0,264,753031,13434,264
2021-06-22,5,0,5,227,0,227,753258,13439,227
2021-06-23,7,0,7,228,0,228,753486,13446,228
2021-06-24,5,0,5,235,0,235,753721,13451,235
2021-06-25,5,0,5,217,0,217,753938,13456,217
2021-06-26,8,0,8,150,0,150,754088,13464,150
2021-06-27,2,0,2,130,0,130,754218,13466,130
2021-06-28,1,0,1,322,0,322,754540,13467,322
2021-06-29,4,0,4,264,0,264,754804,13471,264
2021-06-30,8,0,8,272,0,272,755076,13479,272
2021-07-01,9,0,9,293,0,293,755369,13488,293
2021-07-02,5,0,5,269,0,269,755638,13493,269
2021-07-03,3,0,3,194,0,194,755832,13496,194
2021-07-04,3,0,3,85,0,85,755917,13499,85
2021-07-05,5,0,5,312,0,312,756229,13504,312
2021-07-06,4,0,4,453,0,453,756682,13508,453
2021-07-07,6,0,6,406,0,406,757088,13514,406
2021-07-08,2,0,2,415,0,415,757503,13516,416
2021-07-09,4,0,4,392,0,392,757895,13520,391
2021-07-10,8,0,8,260,0,260,758155,13528,260
2021-07-11,3,0,3,260,0,260,758415,13531,260
2021-07-12,6,0,6,696,0,696,759111,13537,696
2021-07-13,2,0,2,545,0,545,759656,13539,545
2021-07-14,1,0,1,536,0,536,760192,13540,536
2021-07-15,4,0,4,585,0,585,760777,13544,585
2021-07-16,2,0,2,550,0,550,761327,13546,550
2021-07-17,5,0,5,374,0,374,761701,13551,374
2021-07-18,1,0,1,444,0,444,762145,13552,444
2021-07-19,0,0,0,866,0,866,763011,13552,866
2021-07-20,2,0,2,818,0,818,763829,13554,818
2021-07-21,6,0,6,851,0,851,764680,13560,851
2021-07-22,3,0,3,925,0,925,765605,13563,925
2021-07-23,5,0,5,799,0,799,766404,13568,799
2021-07-24,7,0,7,604,0,604,767008,13575,604
2021-07-25,5,0,5,715,0,715,767723,13580,715
2021-07-26,5,0,5,1394,0,1394,769117,13585,1394
2021-07-27,9,0,9,1206,0,1206,770323,13594,1206
2021-07-28,6,0,6,1358,0,1358,771681,13600,1359
2021-07-29,9,0,9,1362,0,1362,773043,13609,1361
2021-07-30,5,0,5,1260,0,1260,774303,13614,1260
2021-07-31,9,0,9,921,0,921,775224,13623,921
2021-08-01,9,0,9,981,0,981,776205,13632,981
2021-08-02,13,0,13,2156,0,2156,778361,13645,2156
2021-08-03,8,0,8,1955,0,1955,780316,13653,1955
2021-08-04,6,0,6,2002,0,2002,782318,13659,2002
2021-08-05,8,0,8,2205,0,2205,784523,13667,2205
2021-08-06,13,0,13,2095,0,2095,786618,13680,2095
2021-08-07,8,0,8,1434,0,1434,788052,13688,1434
2021-08-08,18,0,18,1355,0,1355,789407,13706,1355
2021-08-09,15,0,15,3260,0,3260,792667,13721,3260
2021-08-10,17,0,17,3019,0,3019,795686,13738,3020
2021-08-11,11,0,11,2809,0,2809,798495,13749,2808
2021-08-12,12,0,12,3071,0,3071,801566,13761,3071
2021-08-13,13,0,13,2733,0,2733,804299,13774,2734
2021-08-14,11,0,11,1769,0,1769,806068,13785,1768
2021-08-15,21,0,21,1617,0,1617,807685,13806,1617
2021-08-16,18,0,18,4549,0,4549,812234,13824,4549
2021-08-17,19,0,19,4050,0,4050,816284,13843,4050
2021-08-18,14,0,14,4123,0,4123,820407,13857,4124
2021-08-19,24,0,24,3993,0,3993,824400,13881,3992
2021-08-20,19,0,19,3788,0,3788,828188,13900,3788
2021-08-21,34,0,34,2316,0,2316,830504,13934,2316
2021-08-22,25,0,25,2040,0,2040,832544,13959,2040
2021-08-23,24,0,24,5663,0,5663,838207,13983,5663
2021-08-24,17,0,17,5167,0,5167,843374,14000,5167
2021-08-25,29,0,29,4774,0,4774,848148,14029,4774
2021-08-26,24,0,24,4756,0,4756,852904,14053,4756
2021-08-27,32,0,32,4455,0,4455,857359,14085,4455
2021-08-28,25,0,25,2571,0,2571,859930,14110,2571
2021-08-29,38,0,38,2098,0,2098,862028,14148,2099
2021-08-30,27,0,27,5944,0,5944,867972,14175,5943
2021-08-31,24,0,24,5159,0,5159,873131,14199,5159
2021-09-01,37,0,37,4996,0,4996,878127,14236,4996
2021-09-02,23,0,23,4492,0,4492,882619,14259,4493
2021-09-03,31,0,31,4326,0,4326,886945,14290,4326
2021-09-04,22,0,22,2509,0,2509,889454,14312,2508
2021-09-05,37,0,37,2111,0,2111,891565,14349,2111
2021-09-06,42,0,42,1775,0,1775,893340,14391,1776
2021-09-07,39,0,39,6668,0,6668,900008,14430,6667
2021-09-08,33,0,33,5244,0,5244,905252,14463,5244
2021-09-09,38,0,38,4707,0,4707,909959,14501,4708
2021-09-10,49,0,49,4109,0,4109,914068,14550,4108
2021-09-11,38,0,38,2447,0,2447,916515,14588,2448
2021-09-12,41,0,41,2039,0,2039,918554,14629,2039
2021-09-13,44,0,44,4972,0,4972,923526,14673,4971
2021-09-14,51,0,51,4396,0,4396,927922,14724,4396
2021-09-15,50,0,50,3785,0,3785,931707,14774,3786
2021-09-16,35,0,35,3533,0,3533,935240,14809,3532
2021-09-17,49,0,49,3394,0,3394,938634,14858,3394
2021-09-18,31,0,31,1964,0,1964,940598,14889,1964
2021-09-19,39,0,39,1557,0,1557,942155,14928,1557
2021-09-20,39,0,39,4162,0,4162,946317,14967,4162
2021-09-21,41,0,41,3431,0,3431,949748,15008,3431
2021-09-22,40,0,40,3064,0,3064,952812,15048,3064
2021-09-23,49,0,49,2869,0,2869,955681,15097,2869
2021-09-24,48,0,48,2540,0,2540,958221,15145,2540
2021-09-25,42,0,42,1554,0,1554,959775,15187,1554
2021-09-26,43,0,43,1388,0,1388,961163,15230,1388
2021-09-27,46,0,46,3828,0,3828,964991,15276,3828
2021-09-28,44,0,44,3001,0,3001,967992,15320,3001
2021-09-29,32,0,32,2936,0,2936,970928,15352,2936
2021-09-30,35,0,35,2697,0,2697,973625,15387,2697
2021-10-01,40,0,40,2454,0,2454,976079,15427,2454
2021-10-02,30,0,30,1460,0,1460,977539,15457,1460
2021-10-03,49,0,49,1294,0,1294,978833,15506,1294
2021-10-04,42,0,42,3293,0,3293,982126,15548,3293
2021-10-05,36,0,36,2741,0,2741,984867,15584,2741
2021-10-06,35,0,35,2570,0,2570,987437,15619,2570
2021-10-07,30,0,30,2362,0,2362,989799,15649,2363
2021-10-08,28,0,28,2086,0,2086,991885,15677,2085
2021-10-09,28,0,28,1263,0,1263,993148,15705,1263
2021-10-10,32,0,32,1069,0,1069,994217,15737,1069
2021-10-11,32,0,32,2741,0,2741,996958,15769,2743
2021-10-12,36,0,36,2374,0,2374,999332,15805,2372
2021-10-13,26,0,26,2047,0,2047,1001379,15831,2047
2021-10-14,38,0,38,1871,0,1871,1003250,15869,1871
2021-10-15,29,0,29,1648,0,1648,1004898,15898,1648
2021-10-16,31,0,31,1016,0,1016,1005914,15929,1016
2021-10-17,27,0,27,858,0,858,1006772,15956,858
2021-10-18,28,0,28,2257,0,2257,1009029,15984,2257
2021-10-19,34,0,34,1936,0,1936,1010965,16018,1936
2021-10-20,33,0,33,1853,0,1853,1012818,16051,1853
2021-10-21,28,0,28,1645,0,1645,1014463,16079,1645
2021-10-22,34,0,34,1463,0,1463,1015926,16113,1463
2021-10-23,26,0,26,961,0,961,1016887,16139,961
2021-10-24,29,0,29,858,0,858,1017745,16168,858
2021-10-25,22,0,22,2246,0,2246,1019991,16190,2246
2021-10-26,33,0,33,2009,0,2009,1022000,16223,2009
2021-10-27,24,0,24,1882,0,1882,1023882,16247,1882
2021-10-28,24,0,24,1715,0,1715,1025597,16271,1715
2021-10-29,24,0,24,1767,0,1767,1027364,16295,1767
2021-10-30,26,0,26,1094,0,1094,1028458,16321,1094
2021-10-31,24,0,24,839,0,839,1029297,16345,839
2021-11-01,26,0,26,2522,0,2522,1031819,16371,2522
2021-11-02,26,0,26,2181,0,2181,1034000,16397,2181
2021-11-03,25,0,25,2185,0,2185,1036185,16422,2185
2021-11-04,18,0,18,2161,0,2161,1038346,16440,2161
2021-11-05,28,0,28,2114,0,2114,1040460,16468,2114
2021-11-06,32,0,32,1312,0,1312,1041772,16500,1312
2021-11-07,25,0,25,1252,0,1252,1043024,16525,1252
2021-11-08,23,0,23,3392,0,3392,1046416,16548,3392
2021-11-09,23,0,23,2934,0,2934,1049350,16571,2935
2021-11-10,26,0,26,2946,0,2946,1052296,16597,2945
2021-11-11,33,0,33,2686,0,2686,1054982,16630,2686
2021-11-12,29,0,29,2882,0,2882,1057864,16659,2882
2021-11-13,23,0,23,1683,0,1683,1059547,16682,1683
2021-11-14,25,0,25,1546,0,1546,1061093,16707,1546
2021-11-15,30,0,30,4160,0,4160,1065253,16737,4160
2021-11-16,31,0,31,3586,0,3586,1068839,16768,3586
2021-11-17,23,0,23,3839,0,3839,1072678,16791,3839
2021-11-18,30,0,30,3610,0,3610,1076288,16821,3610
2021-11-19,35,0,35,3377,0,3377,1079665,16856,3377
2021-11-20,22,0,22,2089,0,2089,1081754,16878,2089
2021-11-21,31,0,31,1876,0,1876,1083630,16909,1876
2021-11-22,27,0,27,4575,0,4575,1088205,16936,4575
2021-11-23,23,0,23,4004,0,4004,1092209,16959,4004
2021-11-24,39,0,39,3596,0,3596,1095805,16998,3596
2021-11-25,37,0,37,689,0,689,1096494,17035,689
2021-11-26,30,0,30,3115,0,3115,1099609,17065,3115
2021-11-27,49,0,49,2512,0,2512,1102121,17114,2512
2021-11-28,36,0,36,2413,0,2413,1104534,17150,2413
2021-11-29,37,0,37,7049,0,7049,1111583,17187,7049
2021-11-30,34,0,34,5896,0,5896,1117479,17221,5896
2021-12-01,45,0,45,5746,0,5746,1123225,17266,5746
2021-12-02,39,0,39,5453,0,5453,1128678,17305,5453
2021-12-03,48,0,48,4836,0,4836,1133514,17353,4836
2021-12-04,34,0,34,2927,0,2927,1136441,17387,2928
2021-12-05,46,0,46,2300,0,2300,1138741,17433,2299
2021-12-06,49,0,49,6461,0,6461,1145202,17482,6461
2021-12-07,56,0,56,5462,0,5462,1150664,17538,5462
2021-12-08,49,0,49,5289,0,5289,1155953,17587,5289
2021-12-09,61,0,61,4893,0,4893,1160846,17648,4893
2021-12-10,51,0,51,4374,0,4374,1165220,17699,4374
2021-12-11,52,0,52,2533,0,2533,1167753,17751,2533
2021-12-12,43,0,43,2209,0,2209,1169962,17794,2209
2021-12-13,44,0,44,6087,0,6087,1176049,17838,6087
2021-12-14,69,0,69,5323,0,5323,1181372,17907,5323
2021-12-15,61,0,61,4979,0,4979,1186351,17968,4979
2021-12-16,64,0,64,4793,0,4793,1191144,18032,4793
2021-12-17,55,0,55,4269,0,4269,1195413,18087,4270
2021-12-18,58,0,58,2657,0,2657,1198070,18145,2656
2021-12-19,65,0,65,2209,0,2209,1200279,18210,2209
2021-12-20,49,0,49,6059,0,6059,1206338,18259,6059
2021-12-21,70,0,70,5910,0,5910,1212248,18329,5910
2021-12-22,69,0,69,6472,0,6472,1218720,18398,6473
2021-12-23,63,0,63,6062,0,6062,1224782,18461,6061
2021-12-24,55,0,55,3039,0,3039,1227821,18516,3039
2021-12-25,66,0,66,1406,0,1406,1229227,18582,1407
2021-12-26,57,0,57,3938,0,3938,1233165,18639,3937
2021-12-27,66,0,66,11739,0,11739,1244904,18705,11740
2021-12-28,59,0,59,12683,0,12683,1257587,18764,12682
2021-12-29,76,0,76,13160,0,13160,1270747,18840,13160
2021-12-30,68,0,68,11995,0,11995,1282742,18908,11995
2021-12-31,63,0,63,6197,0,6197,1288939,18971,6197
2022-01-01,57,0,57,3053,0,3053,1291992,19028,3053
2022-01-02,56,0,56,5756,0,5756,1297748,19084,5756
2022-01-03,73,0,73,16466,0,16466,1314214,19157,16468
2022-01-04,59,0,59,18570,0,18570,1332784,19216,18568
2022-01-05,51,0,51,17544,0,17544,1350328,19267,17545
2022-01-06,59,0,59,15941,0,15941,1366269,19326,15942
2022-01-07,69,0,69,13853,0,13853,1380122,19395,13853
2022-01-08,71,0,71,8195,0,8195,1388317,19466,8193
2022-01-09,67,0,67,6115,0,6115,1394432,19533,6115
2022-01-10,70,0,70,18998,0,18998,1413430,19603,19000
2022-01-11,84,0,84,18524,0,18524,1431954,19687,18523
2022-01-12,81,0,81,18213,0,18213,1450167,19768,18212
2022-01-13,85,0,85,17209,0,17209,1467376,19853,17209
2022-01-14,76,0,76,15080,0,15080,1482456,19929,15080
2022-01-15,74,0,74,7767,0,7767,1490223,20003,7768
2022-01-16,82,0,82,5702,0,5702,1495925,20085,5701
2022-01-17,73,0,73,14921,0,14921,1510846,20158,14921
2022-01-18,66,0,66,18038,0,18038,1528884,20224,18038
2022-01-19,86,0,86,17257,0,17257,1546141,20310,17257
2022-01-20,76,0,76,14831,0,14831,1560972,20386,14831
2022-01-21,82,0,82,12665,0,12665,1573637,20468,12665
2022-01-22,52,0,52,5972,0,5972,1579609,20520,5972
2022-01-23,73,0,73,4103,0,4103,1583712,20593,4103
2022-01-24,68,0,68,12591,0,12591,1596303,20661,12591
2022-01-25,57,0,57,10867,0,10867,1607170,20718,10867
2022-01-26,62,0,62,9733,0,9733,1616903,20780,9735
2022-01-27,72,0,72,8739,0,8739,1625642,20852,8737
2022-01-28,62,0,62,6654,0,6654,1632296,20914,6654
2022-01-29,78,0,78,3373,0,3373,1635669,20992,3374
2022-01-30,65,0,65,2678,0,2678,1638347,21057,2677
2022-01-31,57,0,57,7264,0,7264,1645611,21114,7266
2022-02-01,53,0,53,5517,0,5517,1651128,21167,5515
2022-02-02,58,0,58,3448,0,3448,1654576,21225,3448
2022-02-03,53,0,53,1093,0,1093,1655669,21278,1093
2022-02-04,54,0,54,2178,0,2178,1657847,21332,2178
2022-02-05,65,0,65,2020,0,2020,1659867,21397,2020
2022-02-06,41,0,41,1558,0,1558,1661425,21438,1558
2022-02-07,43,0,43,3803,0,3803,1665228,21481,3803
2022-02-08,56,0,56,2512,0,2512,1667740,21537,2512
2022-02-09,52,0,52,2231,0,2231,1669971,21589,2232
2022-02-10,46,0,46,1926,0,1926,1671897,21635,1925
2022-02-11,40,0,40,1560,0,1560,1673457,21675,1560
2022-02-12,54,0,54,784,0,784,1674241,21729,784
2022-02-13,57,0,57,646,0,646,1674887,21786,646
2022-02-14,43,0,43,1589,0,1589,1676476,21829,1589
2022-02-15,43,0,43,1290,0,1290,1677766,21872,1291
2022-02-16,33,0,33,1323,0,1323,1679089,21905,1322
2022-02-17,49,0,49,1005,0,1005,1680094,21954,1005
2022-02-18,37,0,37,818,0,818,1680912,21991,818
2022-02-19,36,0,36,474,0,474,1681386,22027,474
2022-02-20,28,0,28,429,0,429,1681815,22055,429
2022-02-21,29,0,29,934,0,934,1682749,22084,934
2022-02-22,35,0,35,790,0,790,1683539,22119,790
2022-02-23,25,0,25,685,0,685,1684224,22144,685
2022-02-24,21,0,21,618,0,618,1684842,22165,618
2022-02-25,29,0,29,566,0,566,1685408,22194,566
2022-02-26,15,0,15,275,0,275,1685683,22209,275
2022-02-27,20,0,20,211,0,211,1685894,22229,211
2022-02-28,21,0,21,509,0,509,1686403,22250,509
2022-03-01,23,0,23,429,0,429,1686832,22273,429
2022-03-02,18,0,18,401,0,401,1687233,22291,401
2022-03-03,16,0,16,411,0,411,1687644,22307,411
2022-03-04,20,0,20,349,0,349,1687993,22327,349
2022-03-05,10,0,10,195,0,195,1688188,22337,195
2022-03-06,18,0,18,168,0,168,1688356,22355,168
2022-03-07,12,0,12,428,0,428,1688784,22367,428
2022-03-08,16,0,16,325,0,325,1689109,22383,325
2022-03-09,19,0,19,277,0,277,1689386,22402,277
2022-03-10,20,0,20,294,0,294,1689680,22422,294
2022-03-11,13,0,13,239,0,239,1689919,22435,239
2022-03-12,16,0,16,136,0,136,1690055,22451,136
2022-03-13,14,0,14,124,0,124,1690179,22465,124
2022-03-14,8,0,8,300,0,300,1690479,22473,300
2022-03-15,10,0,10,256,0,256,1690735,22483,256
2022-03-16,8,0,8,236,0,236,1690971,22491,236
2022-03-17,7,0,7,202,0,202,1691173,22498,202
2022-03-18,8,0,8,224,0,224,1691397,22506,224
2022-03-19,8,0,8,151,0,151,1691548,22514,151
2022-03-20,10,0,10,118,0,118,1691666,22524,118
2022-03-21,6,0,6,271,0,271,1691937,22530,271
2022-03-22,11,0,11,219,0,219,1692156,22541,219
2022-03-23,5,0,5,209,0,209,1692365,22546,209
2022-03-24,6,0,6,239,0,239,1692604,22552,239
2022-03-25,10,0,10,203,0,203,1692807,22562,203
2022-03-26,6,0,6,130,0,130,1692937,22568,130
2022-03-27,5,0,5,123,0,123,1693060,22573,123
2022-03-28,4,0,4,216,0,216,1693276,22577,216
2022-03-29,5,0,5,206,0,206,1693482,22582,206
2022-03-30,11,NULL,NULL,222,NULL,NULL,1693704,22593,222
2022-03-31,7,NULL,NULL,188,NULL,NULL,1693892,22600,188
2022-04-01,2,NULL,NULL,187,NULL,NULL,1694079,22602,187
2022-04-02,5,NULL,NULL,128,NULL,NULL,1694207,22607,128
2022-04-03,2,NULL,NULL,115,NULL,NULL,1694322,22609,115
2022-04-04,4,NULL,NULL,257,NULL,NULL,1694579,22613,257
2022-04-05,5,NULL,NULL,238,NULL,NULL,1694817,22618,238
2022-04-06,2,NULL,NULL,251,NULL,NULL,1695068,22620,251
2022-04-07,4,NULL,NULL,221,NULL,NULL,1695289,22624,221
2022-04-08,4,NULL,NULL,189,NULL,NULL,1695478,22628,189
2022-04-09,4,NULL,NULL,122,NULL,NULL,1695600,22632,122
2022-04-10,7,NULL,NULL,167,NULL,NULL,1695767,22639,167
2022-04-11,3,NULL,NULL,353,NULL,NULL,1696120,22642,353
2022-04-12,4,NULL,NULL,360,NULL,NULL,1696480,22646,360
2022-04-13,6,NULL,NULL,362,NULL,NULL,1696842,22652,362
2022-04-14,0,NULL,NULL,379,NULL,NULL,1697221,22652,379
2022-04-15,2,NULL,NULL,333,NULL,NULL,1697554,22654,333
2022-04-16,3,NULL,NULL,264,NULL,NULL,1697818,22657,264
2022-04-17,0,NULL,NULL,180,NULL,NULL,1697998,22657,180
2022-04-18,2,NULL,NULL,554,NULL,NULL,1698552,22659,554
2022-04-19,6,NULL,NULL,487,NULL,NULL,1699039,22665,487
2022-04-20,7,NULL,NULL,551,NULL,NULL,1699590,22672,551
2022-04-21,7,NULL,NULL,612,NULL,NULL,1700202,22679,612
2022-04-22,2,NULL,NULL,504,NULL,NULL,1700706,22681,504
2022-04-23,5,NULL,NULL,394,NULL,NULL,1701100,22686,394
2022-04-24,1,NULL,NULL,356,NULL,NULL,1701456,22687,356
2022-04-25,4,NULL,NULL,769,NULL,NULL,1702225,22691,769
2022-04-26,6,NULL,NULL,727,NULL,NULL,1702952,22697,728
2022-04-27,4,NULL,NULL,776,NULL,NULL,1703728,22701,775
2022-04-28,7,NULL,NULL,645,NULL,NULL,1704373,22708,645
2022-04-29,1,NULL,NULL,641,NULL,NULL,1705014,22709,641
2022-04-30,5,NULL,NULL,469,NULL,NULL,1705483,22714,469
2022-05-01,3,NULL,NULL,444,NULL,NULL,1705927,22717,444
2022-05-02,6,NULL,NULL,972,NULL,NULL,1706899,22723,972
2022-05-03,1,NULL,NULL,1004,NULL,NULL,1707903,22724,1004
2022-05-04,5,NULL,NULL,951,NULL,NULL,1708854,22729,951
2022-05-05,1,NULL,NULL,1054,NULL,NULL,1709908,22730,1054
2022-05-06,3,NULL,NULL,983,NULL,NULL,1710891,22733,983
2022-05-07,1,NULL,NULL,625,NULL,NULL,1711516,22734,625
2022-05-08,4,NULL,NULL,599,NULL,NULL,1712115,22738,599
2022-05-09,5,NULL,NULL,1404,NULL,NULL,1713519,22743,1404
2022-05-10,2,NULL,NULL,1283,NULL,NULL,1714802,22745,1283
2022-05-11,6,NULL,NULL,1319,NULL,NULL,1716121,22751,1319
2022-05-12,6,NULL,NULL,1304,NULL,NULL,1717425,22757,1304
2022-05-13,4,NULL,NULL,1096,NULL,NULL,1718521,22761,1096
2022-05-14,4,NULL,NULL,691,NULL,NULL,1719212,22765,691
2022-05-15,4,NULL,NULL,712,NULL,NULL,1719924,22769,712
2022-05-16,6,NULL,NULL,1522,NULL,NULL,1721446,22775,1522
2022-05-17,3,NULL,NULL,1513,NULL,NULL,1722959,22778,1513
2022-05-18,5,NULL,NULL,1388,NULL,NULL,1724347,22783,1389
2022-05-19,2,NULL,NULL,1368,NULL,NULL,1725715,22785,1367
2022-05-20,5,NULL,NULL,1244,NULL,NULL,1726959,22790,1244
2022-05-21,3,NULL,NULL,809,NULL,NULL,1727768,22793,809
2022-05-22,2,NULL,NULL,844,NULL,NULL,1728612,22795,844
2022-05-23,5,NULL,NULL,1625,NULL,NULL,1730237,22800,1625
2022-05-24,4,NULL,NULL,1419,NULL,NULL,1731656,22804,1419
2022-05-25,8,NULL,NULL,1281,NULL,NULL,1732937,22812,1281
2022-05-26,3,NULL,NULL,1450,NULL,NULL,1734387,22815,1450
2022-05-27,2,NULL,NULL,1256,NULL,NULL,1735643,22817,1256
2022-05-28,5,NULL,NULL,836,NULL,NULL,1736479,22822,836
2022-05-29,5,NULL,NULL,752,NULL,NULL,1737231,22827,752
2022-05-30,4,NULL,NULL,662,NULL,NULL,1737893,22831,662
2022-05-31,2,NULL,NULL,2054,NULL,NULL,1739947,22833,2054
2022-06-01,6,NULL,NULL,1646,NULL,NULL,1741593,22839,1646
2022-06-02,8,NULL,NULL,1447,NULL,NULL,1743040,22847,1447
2022-06-03,2,NULL,NULL,1187,NULL,NULL,1744227,22849,1187
2022-06-04,4,NULL,NULL,764,NULL,NULL,1744991,22853,764
2022-06-05,4,NULL,NULL,848,NULL,NULL,1745839,22857,848
2022-06-06,4,NULL,NULL,1635,NULL,NULL,1747474,22861,1635
2022-06-07,5,NULL,NULL,1481,NULL,NULL,1748955,22866,1481
2022-06-08,7,NULL,NULL,1448,NULL,NULL,1750403,22873,1448
2022-06-09,9,NULL,NULL,1291,NULL,NULL,1751694,22882,1291
2022-06-10,6,NULL,NULL,1211,NULL,NULL,1752905,22888,1211
2022-06-11,2,NULL,NULL,751,NULL,NULL,1753656,22890,751
2022-06-12,3,NULL,NULL,773,NULL,NULL,1754429,22893,773
2022-06-13,3,NULL,NULL,1496,NULL,NULL,1755925,22896,1496
2022-06-14,1,NULL,NULL,1448,NULL,NULL,1757373,22897,1448
2022-06-15,7,NULL,NULL,1481,NULL,NULL,1758854,22904,1481
2022-06-16,8,NULL,NULL,1345,NULL,NULL,1760199,22912,1345
2022-06-17,3,NULL,NULL,1232,NULL,NULL,1761431,22915,1232
2022-06-18,4,NULL,NULL,795,NULL,NULL,1762226,22919,795
2022-06-19,7,NULL,NULL,780,NULL,NULL,1763006,22926,780
2022-06-20,5,NULL,NULL,1730,NULL,NULL,1764736,22931,1730
2022-06-21,8,NULL,NULL,1550,NULL,NULL,1766286,22939,1550
2022-06-22,4,NULL,NULL,1696,NULL,NULL,1767982,22943,1696
2022-06-23,2,NULL,NULL,1468,NULL,NULL,1769450,22945,1468
2022-06-24,5,NULL,NULL,1420,NULL,NULL,1770870,22950,1420
2022-06-25,8,NULL,NULL,989,NULL,NULL,1771859,22958,989
2022-06-26,4,NULL,NULL,932,NULL,NULL,1772791,22962,932
2022-06-27,8,NULL,NULL,2069,NULL,NULL,1774860,22970,2071
2022-06-28,9,NULL,NULL,1768,NULL,NULL,1776628,22979,1766
2022-06-29,9,NULL,NULL,1849,NULL,NULL,1778477,22988,1849
2022-06-30,6,NULL,NULL,1736,NULL,NULL,1780213,22994,1736
2022-07-01,5,NULL,NULL,1552,NULL,NULL,1781765,22999,1552
2022-07-02,7,NULL,NULL,1018,NULL,NULL,1782783,23006,1018
2022-07-03,1,NULL,NULL,1042,NULL,NULL,1783825,23007,1042
2022-07-04,7,NULL,NULL,750,NULL,NULL,1784575,23014,752
2022-07-05,3,NULL,NULL,2595,NULL,NULL,1787170,23017,2593
2022-07-06,7,NULL,NULL,2163,NULL,NULL,1789333,23024,2163
2022-07-07,11,NULL,NULL,2097,NULL,NULL,1791430,23035,2097
2022-07-08,5,NULL,NULL,1955,NULL,NULL,1793385,23040,1955
2022-07-09,6,NULL,NULL,1283,NULL,NULL,1794668,23046,1283
2022-07-10,6,NULL,NULL,1121,NULL,NULL,1795789,23052,1121
2022-07-11,10,NULL,NULL,2069,NULL,NULL,1797858,23062,2069
2022-07-12,4,NULL,NULL,2372,NULL,NULL,1800230,23066,2372
2022-07-13,13,NULL,NULL,2288,NULL,NULL,1802518,23079,2288
2022-07-14,10,NULL,NULL,2057,NULL,NULL,1804575,23089,2057
2022-07-15,7,NULL,NULL,1876,NULL,NULL,1806451,23096,1876
2022-07-16,6,NULL,NULL,1338,NULL,NULL,1807789,23102,1339
2022-07-17,10,NULL,NULL,1375,NULL,NULL,1809164,23112,1374
2022-07-18,14,NULL,NULL,2909,NULL,NULL,1812073,23126,2909
2022-07-19,6,NULL,NULL,2677,NULL,NULL,1814750,23132,2677
2022-07-20,6,NULL,NULL,2529,NULL,NULL,1817279,23138,2529
2022-07-21,9,NULL,NULL,2378,NULL,NULL,1819657,23147,2378
2022-07-22,11,NULL,NULL,2037,NULL,NULL,1821694,23158,2037
2022-07-23,6,NULL,NULL,1427,NULL,NULL,1823121,23164,1427
2022-07-24,5,NULL,NULL,1452,NULL,NULL,1824573,23169,1452
2022-07-25,9,NULL,NULL,3111,NULL,NULL,1827684,23178,3111
2022-07-26,10,NULL,NULL,2688,NULL,NULL,1830372,23188,2688
2022-07-27,8,NULL,NULL,1926,NULL,NULL,1832298,23196,1926
2022-07-28,6,NULL,NULL,2252,NULL,NULL,1834550,23202,2252
2022-07-29,5,NULL,NULL,2087,NULL,NULL,1836637,23207,2087
2022-07-30,10,NULL,NULL,1399,NULL,NULL,1838036,23217,1399
2022-07-31,17,NULL,NULL,1466,NULL,NULL,1839502,23234,1466
2022-08-01,10,NULL,NULL,2989,NULL,NULL,1842491,23244,2989
2022-08-02,12,NULL,NULL,2573,NULL,NULL,1845064,23256,2573
2022-08-03,8,NULL,NULL,2511,NULL,NULL,1847575,23264,2511
2022-08-04,12,NULL,NULL,2205,NULL,NULL,1849780,23276,2205
2022-08-05,11,NULL,NULL,2122,NULL,NULL,1851902,23287,2122
2022-08-06,8,NULL,NULL,1397,NULL,NULL,1853299,23295,1397
2022-08-07,7,NULL,NULL,1320,NULL,NULL,1854619,23302,1320
2022-08-08,10,NULL,NULL,3020,NULL,NULL,1857639,23312,3020
2022-08-09,12,NULL,NULL,2552,NULL,NULL,1860191,23324,2553
2022-08-10,8,NULL,NULL,2415,NULL,NULL,1862606,23332,2414
2022-08-11,4,NULL,NULL,2262,NULL,NULL,1864868,23336,2262
2022-08-12,9,NULL,NULL,1795,NULL,NULL,1866663,23345,1795
2022-08-13,6,NULL,NULL,1224,NULL,NULL,1867887,23351,1224
2022-08-14,15,NULL,NULL,1361,NULL,NULL,1869248,23366,1361
2022-08-15,5,NULL,NULL,2776,NULL,NULL,1872024,23371,2777
2022-08-16,10,NULL,NULL,2648,NULL,NULL,1874672,23381,2647
2022-08-17,7,NULL,NULL,2656,NULL,NULL,1877328,23388,2656
2022-08-18,10,NULL,NULL,2231,NULL,NULL,1879559,23398,2231
2022-08-19,11,NULL,NULL,2069,NULL,NULL,1881628,23409,2069
2022-08-20,17,NULL,NULL,1215,NULL,NULL,1882843,23426,1215
2022-08-21,7,NULL,NULL,1432,NULL,NULL,1884275,23433,1433
2022-08-22,12,NULL,NULL,3034,NULL,NULL,1887309,23445,3033
2022-08-23,13,NULL,NULL,2536,NULL,NULL,1889845,23458,2536
2022-08-24,10,NULL,NULL,2314,NULL,NULL,1892159,23468,2314
2022-08-25,9,NULL,NULL,2048,NULL,NULL,1894207,23477,2048
2022-08-26,9,NULL,NULL,1865,NULL,NULL,1896072,23486,1865
2022-08-27,7,NULL,NULL,1128,NULL,NULL,1897200,23493,1128
2022-08-28,12,NULL,NULL,1065,NULL,NULL,1898265,23505,1065
2022-08-29,11,NULL,NULL,2358,NULL,NULL,1900623,23516,2358
2022-08-30,10,NULL,NULL,1904,NULL,NULL,1902527,23526,1904
2022-08-31,8,NULL,NULL,1763,NULL,NULL,1904290,23534,1763
2022-09-01,5,NULL,NULL,1591,NULL,NULL,1905881,23539,1591
2022-09-02,12,NULL,NULL,1278,NULL,NULL,1907159,23551,1278
2022-09-03,6,NULL,NULL,783,NULL,NULL,1907942,23557,783
2022-09-04,17,NULL,NULL,707,NULL,NULL,1908649,23574,707
2022-09-05,8,NULL,NULL,663,NULL,NULL,1909312,23582,663
2022-09-06,9,NULL,NULL,1688,NULL,NULL,1911000,23591,1688
2022-09-07,6,NULL,NULL,1286,NULL,NULL,1912286,23597,1286
2022-09-08,6,NULL,NULL,1199,NULL,NULL,1913485,23603,1199
2022-09-09,5,NULL,NULL,972,NULL,NULL,1914457,23608,972
2022-09-10,8,NULL,NULL,527,NULL,NULL,1914984,23616,527
2022-09-11,8,NULL,NULL,480,NULL,NULL,1915464,23624,480
2022-09-12,9,NULL,NULL,1151,NULL,NULL,1916615,23633,1151
2022-09-13,9,NULL,NULL,923,NULL,NULL,1917538,23642,923
2022-09-14,7,NULL,NULL,926,NULL,NULL,1918464,23649,926
2022-09-15,4,NULL,NULL,759,NULL,NULL,1919223,23653,759
2022-09-16,6,NULL,NULL,724,NULL,NULL,1919947,23659,724
2022-09-17,8,NULL,NULL,408,NULL,NULL,1920355,23667,408
2022-09-18,10,NULL,NULL,439,NULL,NULL,1920794,23677,439
2022-09-19,11,NULL,NULL,972,NULL,NULL,1921766,23688,972
2022-09-20,7,NULL,NULL,809,NULL,NULL,1922575,23695,809
2022-09-21,7,NULL,NULL,744,NULL,NULL,1923319,23702,744
2022-09-22,11,NULL,NULL,658,NULL,NULL,1923977,23713,658
2022-09-23,2,NULL,NULL,569,NULL,NULL,1924546,23715,569
2022-09-24,7,NULL,NULL,343,NULL,NULL,1924889,23722,343
2022-09-25,5,NULL,NULL,318,NULL,NULL,1925207,23727,318
2022-09-26,6,NULL,NULL,792,NULL,NULL,1925999,23733,792
2022-09-27,3,NULL,NULL,654,NULL,NULL,1926653,23736,654
2022-09-28,8,NULL,NULL,646,NULL,NULL,1927299,23744,646
2022-09-29,4,NULL,NULL,593,NULL,NULL,1927892,23748,593
2022-09-30,9,NULL,NULL,511,NULL,NULL,1928403,23757,511
2022-10-01,8,NULL,NULL,402,NULL,NULL,1928805,23765,402
2022-10-02,9,NULL,NULL,370,NULL,NULL,1929175,23774,370
2022-10-03,4,NULL,NULL,856,NULL,NULL,1930031,23778,856
2022-10-04,7,NULL,NULL,667,NULL,NULL,1930698,23785,667
2022-10-05,8,NULL,NULL,668,NULL,NULL,1931366,23793,668
2022-10-06,5,NULL,NULL,555,NULL,NULL,1931921,23798,555
2022-10-07,4,NULL,NULL,454,NULL,NULL,1932375,23802,454
2022-10-08,5,NULL,NULL,331,NULL,NULL,1932706,23807,331
2022-10-09,4,NULL,NULL,276,NULL,NULL,1932982,23811,276
2022-10-10,3,NULL,NULL,663,NULL,NULL,1933645,23814,663
2022-10-11,7,NULL,NULL,830,NULL,NULL,1934475,23821,830
2022-10-12,6,NULL,NULL,714,NULL,NULL,1935189,23827,714
2022-10-13,5,NULL,NULL,674,NULL,NULL,1935863,23832,674
2022-10-14,10,NULL,NULL,634,NULL,NULL,1936497,23842,634
2022-10-15,4,NULL,NULL,334,NULL,NULL,1936831,23846,334
2022-10-16,4,NULL,NULL,374,NULL,NULL,1937205,23850,374
2022-10-17,4,NULL,NULL,745,NULL,NULL,1937950,23854,745
2022-10-18,5,NULL,NULL,657,NULL,NULL,1938607,23859,657
2022-10-19,8,NULL,NULL,701,NULL,NULL,1939308,23867,701
2022-10-20,6,NULL,NULL,587,NULL,NULL,1939895,23873,587
2022-10-21,12,NULL,NULL,773,NULL,NULL,1940668,23885,773
2022-10-22,10,NULL,NULL,493,NULL,NULL,1941161,23895,493
2022-10-23,9,NULL,NULL,517,NULL,NULL,1941678,23904,517
2022-10-24,6,NULL,NULL,1238,NULL,NULL,1942916,23910,1238
2022-10-25,2,NULL,NULL,1000,NULL,NULL,1943916,23912,1000
2022-10-26,8,NULL,NULL,955,NULL,NULL,1944871,23920,955
2022-10-27,8,NULL,NULL,836,NULL,NULL,1945707,23928,836
2022-10-28,7,NULL,NULL,642,NULL,NULL,1946349,23935,642
2022-10-29,8,NULL,NULL,407,NULL,NULL,1946756,23943,407
2022-10-30,10,NULL,NULL,458,NULL,NULL,1947214,23953,458
2022-10-31,6,NULL,NULL,1123,NULL,NULL,1948337,23959,1123
2022-11-01,5,NULL,NULL,965,NULL,NULL,1949302,23964,965
2022-11-02,11,NULL,NULL,987,NULL,NULL,1950289,23975,987
2022-11-03,6,NULL,NULL,898,NULL,NULL,1951187,23981,898
2022-11-04,9,NULL,NULL,842,NULL,NULL,1952029,23990,842
2022-11-05,5,NULL,NULL,505,NULL,NULL,1952534,23995,505
2022-11-06,9,NULL,NULL,507,NULL,NULL,1953041,24004,507
2022-11-07,9,NULL,NULL,989,NULL,NULL,1954030,24013,989
2022-11-08,7,NULL,NULL,921,NULL,NULL,1954951,24020,921
2022-11-09,6,NULL,NULL,785,NULL,NULL,1955736,24026,785
2022-11-10,6,NULL,NULL,854,NULL,NULL,1956590,24032,854
2022-11-11,10,NULL,NULL,723,NULL,NULL,1957313,24042,723
2022-11-12,7,NULL,NULL,462,NULL,NULL,1957775,24049,462
2022-11-13,6,NULL,NULL,456,NULL,NULL,1958231,24055,456
2022-11-14,2,NULL,NULL,1085,NULL,NULL,1959316,24057,1085
2022-11-15,6,NULL,NULL,961,NULL,NULL,1960277,24063,961
2022-11-16,7,NULL,NULL,967,NULL,NULL,1961244,24070,967
2022-11-17,9,NULL,NULL,972,NULL,NULL,1962216,24079,972
2022-11-18,9,NULL,NULL,833,NULL,NULL,1963049,24088,833
2022-11-19,6,NULL,NULL,603,NULL,NULL,1963652,24094,603
2022-11-20,5,NULL,NULL,620,NULL,NULL,1964272,24099,621
2022-11-21,5,NULL,NULL,1407,NULL,NULL,1965679,24104,1406
2022-11-22,6,NULL,NULL,1170,NULL,NULL,1966849,24110,1170
2022-11-23,3,NULL,NULL,1085,NULL,NULL,1967934,24113,1085
2022-11-24,5,NULL,NULL,421,NULL,NULL,1968355,24118,421
2022-11-25,7,NULL,NULL,1074,NULL,NULL,1969429,24125,1074
2022-11-26,9,NULL,NULL,870,NULL,NULL,1970299,24134,870
2022-11-27,5,NULL,NULL,1100,NULL,NULL,1971399,24139,1100
2022-11-28,8,NULL,NULL,1898,NULL,NULL,1973297,24147,1898
2022-11-29,9,NULL,NULL,1848,NULL,NULL,1975145,24156,1848
2022-11-30,3,NULL,NULL,1594,NULL,NULL,1976739,24159,1594
2022-12-01,15,NULL,NULL,1493,NULL,NULL,1978232,24174,1493
2022-12-02,10,NULL,NULL,1470,NULL,NULL,1979702,24184,1470
2022-12-03,4,NULL,NULL,795,NULL,NULL,1980497,24188,795
2022-12-04,10,NULL,NULL,813,NULL,NULL,1981310,24198,813
2022-12-05,8,NULL,NULL,1915,NULL,NULL,1983225,24206,1915
2022-12-06,8,NULL,NULL,1660,NULL,NULL,1984885,24214,1660
2022-12-07,15,NULL,NULL,1600,NULL,NULL,1986485,24229,1600
2022-12-08,12,NULL,NULL,1568,NULL,NULL,1988053,24241,1568
2022-12-09,11,NULL,NULL,1432,NULL,NULL,1989485,24252,1432
2022-12-10,13,NULL,NULL,880,NULL,NULL,1990365,24265,881
2022-12-11,10,NULL,NULL,958,NULL,NULL,1991323,24275,957
2022-12-12,11,NULL,NULL,1937,NULL,NULL,1993260,24286,1937
2022-12-13,15,NULL,NULL,1684,NULL,NULL,1994944,24301,1684
2022-12-14,11,NULL,NULL,1624,NULL,NULL,1996568,24312,1624
2022-12-15,13,NULL,NULL,1451,NULL,NULL,1998019,24325,1451
2022-12-16,11,NULL,NULL,1419,NULL,NULL,1999438,24336,1419
2022-12-17,10,NULL,NULL,908,NULL,NULL,2000346,24346,908
2022-12-18,9,NULL,NULL,810,NULL,NULL,2001156,24355,810
2022-12-19,13,NULL,NULL,1612,NULL,NULL,2002768,24368,1672
2022-12-20,22,NULL,NULL,1487,NULL,NULL,2004255,24390,1427
2022-12-21,14,NULL,NULL,1471,NULL,NULL,2005726,24404,1471
2022-12-22,11,NULL,NULL,981,NULL,NULL,2006707,24415,981
2022-12-23,16,NULL,NULL,594,NULL,NULL,2007301,24431,594
2022-12-24,9,NULL,NULL,552,NULL,NULL,2007853,24440,552
2022-12-25,14,NULL,NULL,393,NULL,NULL,2008246,24454,393
2022-12-26,14,NULL,NULL,1046,NULL,NULL,2009292,24468,1046
2022-12-27,10,NULL,NULL,1427,NULL,NULL,2010719,24478,1427
2022-12-28,19,NULL,NULL,1596,NULL,NULL,2012315,24497,1596
2022-12-29,15,NULL,NULL,1338,NULL,NULL,2013653,24512,1338
2022-12-30,9,NULL,NULL,1148,NULL,NULL,2014801,24521,1148
2022-12-31,12,NULL,NULL,607,NULL,NULL,2015408,24533,607
2023-01-01,13,NULL,NULL,480,NULL,NULL,2015888,24546,481
2023-01-02,9,NULL,NULL,994,NULL,NULL,2016882,24555,993
2023-01-03,16,NULL,NULL,1156,NULL,NULL,2018038,24571,1157
2023-01-04,16,NULL,NULL,1103,NULL,NULL,2019141,24587,1102
2023-01-05,10,NULL,NULL,934,NULL,NULL,2020075,24597,934
2023-01-06,17,NULL,NULL,810,NULL,NULL,2020885,24614,810
2023-01-07,17,NULL,NULL,462,NULL,NULL,2021347,24631,462
2023-01-08,12,NULL,NULL,449,NULL,NULL,2021796,24643,449
2023-01-09,6,NULL,NULL,904,NULL,NULL,2022700,24649,904
2023-01-10,12,NULL,NULL,863,NULL,NULL,2023563,24661,863
2023-01-11,6,NULL,NULL,766,NULL,NULL,2024329,24667,766
2023-01-12,8,NULL,NULL,680,NULL,NULL,2025009,24675,680
2023-01-13,11,NULL,NULL,621,NULL,NULL,2025630,24686,621
2023-01-14,10,NULL,NULL,362,NULL,NULL,2025992,24696,362
2023-01-15,7,NULL,NULL,375,NULL,NULL,2026367,24703,375
2023-01-16,8,NULL,NULL,647,NULL,NULL,2027014,24711,647
2023-01-17,12,NULL,NULL,703,NULL,NULL,2027717,24723,703
2023-01-18,4,NULL,NULL,792,NULL,NULL,2028509,24727,792
2023-01-19,12,NULL,NULL,657,NULL,NULL,2029166,24739,657
2023-01-20,6,NULL,NULL,635,NULL,NULL,2029801,24745,635
2023-01-21,3,NULL,NULL,303,NULL,NULL,2030104,24748,303
2023-01-22,9,NULL,NULL,286,NULL,NULL,2030390,24757,286
2023-01-23,6,NULL,NULL,744,NULL,NULL,2031134,24763,744
2023-01-24,6,NULL,NULL,710,NULL,NULL,2031844,24769,710
2023-01-25,8,NULL,NULL,596,NULL,NULL,2032440,24777,596
2023-01-26,3,NULL,NULL,730,NULL,NULL,2033170,24780,730
2023-01-27,9,NULL,NULL,592,NULL,NULL,2033762,24789,592
2023-01-28,8,NULL,NULL,406,NULL,NULL,2034168,24797,406
2023-01-29,7,NULL,NULL,422,NULL,NULL,2034590,24804,422
2023-01-30,4,NULL,NULL,804,NULL,NULL,2035394,24808,804
2023-01-31,6,NULL,NULL,705,NULL,NULL,2036099,24814,705
2023-02-01,4,NULL,NULL,690,NULL,NULL,2036789,24818,690
2023-02-02,11,NULL,NULL,702,NULL,NULL,2037491,24829,702
2023-02-03,7,NULL,NULL,612,NULL,NULL,2038103,24836,612
2023-02-04,5,NULL,NULL,387,NULL,NULL,2038490,24841,387
2023-02-05,2,NULL,NULL,396,NULL,NULL,2038886,24843,396
2023-02-06,5,NULL,NULL,945,NULL,NULL,2039831,24848,945
2023-02-07,10,NULL,NULL,862,NULL,NULL,2040693,24858,862
2023-02-08,2,NULL,NULL,901,NULL,NULL,2041594,24860,901
2023-02-09,7,NULL,NULL,779,NULL,NULL,2042373,24867,779
2023-02-10,5,NULL,NULL,719,NULL,NULL,2043092,24872,719
2023-02-11,5,NULL,NULL,457,NULL,NULL,2043549,24877,457
2023-02-12,6,NULL,NULL,450,NULL,NULL,2043999,24883,450
2023-02-13,3,NULL,NULL,920,NULL,NULL,2044919,24886,920
2023-02-14,6,NULL,NULL,784,NULL,NULL,2045703,24892,784
2023-02-15,6,NULL,NULL,781,NULL,NULL,2046484,24898,782
2023-02-16,8,NULL,NULL,721,NULL,NULL,2047205,24906,721
2023-02-17,4,NULL,NULL,611,NULL,NULL,2047816,24910,610
2023-02-18,5,NULL,NULL,360,NULL,NULL,2048176,24915,360
2023-02-19,4,NULL,NULL,412,NULL,NULL,2048588,24919,412
2023-02-20,7,NULL,NULL,779,NULL,NULL,2049367,24926,779
2023-02-21,4,NULL,NULL,769,NULL,NULL,2050136,24930,769
2023-02-22,7,NULL,NULL,799,NULL,NULL,2050935,24937,799
2023-02-23,6,NULL,NULL,767,NULL,NULL,2051702,24943,767
2023-02-24,4,NULL,NULL,673,NULL,NULL,2052375,24947,673
2023-02-25,3,NULL,NULL,409,NULL,NULL,2052784,24950,409
2023-02-26,1,NULL,NULL,386,NULL,NULL,2053170,24951,386
2023-02-27,4,NULL,NULL,843,NULL,NULL,2054013,24955,843
2023-02-28,6,NULL,NULL,666,NULL,NULL,2054679,24961,666
2023-03-01,5,NULL,NULL,661,NULL,NULL,2055340,24966,661
2023-03-02,4,NULL,NULL,574,NULL,NULL,2055914,24970,574
2023-03-03,8,NULL,NULL,542,NULL,NULL,2056456,24978,542
2023-03-04,6,NULL,NULL,310,NULL,NULL,2056766,24984,310
2023-03-05,2,NULL,NULL,350,NULL,NULL,2057116,24986,350
2023-03-06,8,NULL,NULL,689,NULL,NULL,2057805,24994,689
2023-03-07,6,NULL,NULL,562,NULL,NULL,2058367,25000,562
2023-03-08,5,NULL,NULL,558,NULL,NULL,2058925,25005,558
2023-03-09,7,NULL,NULL,431,NULL,NULL,2059356,25012,431
2023-03-10,4,NULL,NULL,478,NULL,NULL,2059834,25016,478
2023-03-11,5,NULL,NULL,304,NULL,NULL,2060138,25021,304
2023-03-12,14,NULL,NULL,307,NULL,NULL,2060445,25035,307
2023-03-13,9,NULL,NULL,626,NULL,NULL,2061071,25044,626
2023-03-14,3,NULL,NULL,519,NULL,NULL,2061590,25047,519
2023-03-15,8,NULL,NULL,536,NULL,NULL,2062126,25055,536
2023-03-16,3,NULL,NULL,467,NULL,NULL,2062593,25058,467
2023-03-17,5,NULL,NULL,429,NULL,NULL,2063022,25063,429
2023-03-18,4,NULL,NULL,227,NULL,NULL,2063249,25067,227
2023-03-19,5,NULL,NULL,261,NULL,NULL,2063510,25072,261
2023-03-20,5,NULL,NULL,516,NULL,NULL,2064026,25077,516
2023-03-21,4,NULL,NULL,547,NULL,NULL,2064573,25081,547
2023-03-22,12,NULL,NULL,504,NULL,NULL,2065077,25093,504
2023-03-23,4,NULL,NULL,497,NULL,NULL,2065574,25097,497
2023-03-24,5,NULL,NULL,398,NULL,NULL,2065972,25102,398
2023-03-25,0,NULL,NULL,268,NULL,NULL,2066240,25102,268
2023-03-26,5,NULL,NULL,252,NULL,NULL,2066492,25107,252
2023-03-27,6,NULL,NULL,425,NULL,NULL,2066917,25113,425
2023-03-28,4,NULL,NULL,378,NULL,NULL,2067295,25117,378
2023-03-29,5,NULL,NULL,455,NULL,NULL,2067750,25122,455
2023-03-30,4,NULL,NULL,400,NULL,NULL,2068150,25126,400
2023-03-31,4,NULL,NULL,290,NULL,NULL,2068440,25130,290
2023-04-01,3,NULL,NULL,201,NULL,NULL,2068641,25133,201
2023-04-02,4,NULL,NULL,224,NULL,NULL,2068865,25137,224
2023-04-03,5,NULL,NULL,385,NULL,NULL,2069250,25142,385
2023-04-04,1,NULL,NULL,392,NULL,NULL,2069642,25143,392
2023-04-05,3,NULL,NULL,311,NULL,NULL,2069953,25146,311
2023-04-06,2,NULL,NULL,348,NULL,NULL,2070301,25148,348
2023-04-07,3,NULL,NULL,259,NULL,NULL,2070560,25151,259
2023-04-08,4,NULL,NULL,155,NULL,NULL,2070715,25155,155
2023-04-09,6,NULL,NULL,125,NULL,NULL,2070840,25161,125
2023-04-10,4,NULL,NULL,377,NULL,NULL,2071217,25165,377
2023-04-11,4,NULL,NULL,347,NULL,NULL,2071564,25169,347
2023-04-12,3,NULL,NULL,283,NULL,NULL,2071847,25172,283
2023-04-13,3,NULL,NULL,331,NULL,NULL,2072178,25175,331
2023-04-14,0,NULL,NULL,273,NULL,NULL,2072451,25175,273
2023-04-15,2,NULL,NULL,175,NULL,NULL,2072626,25177,175
2023-04-16,5,NULL,NULL,127,NULL,NULL,2072753,25182,127
2023-04-17,5,NULL,NULL,336,NULL,NULL,2073089,25187,336
2023-04-18,6,NULL,NULL,221,NULL,NULL,2073310,25193,221
2023-04-19,3,NULL,NULL,220,NULL,NULL,2073530,25196,220
2023-04-20,4,NULL,NULL,212,NULL,NULL,2073742,25200,212
2023-04-21,7,NULL,NULL,199,NULL,NULL,2073941,25207,199
2023-04-22,1,NULL,NULL,110,NULL,NULL,2074051,25208,110
2023-04-23,3,NULL,NULL,145,NULL,NULL,2074196,25211,145
2023-04-24,2,NULL,NULL,280,NULL,NULL,2074476,25213,280
2023-04-25,1,NULL,NULL,231,NULL,NULL,2074707,25214,231
2023-04-26,1,NULL,NULL,219,NULL,NULL,2074926,25215,219
2023-04-27,3,NULL,NULL,210,NULL,NULL,2075136,25218,210
2023-04-28,5,NULL,NULL,203,NULL,NULL,2075339,25223,203
2023-04-29,2,NULL,NULL,120,NULL,NULL,2075459,25225,120
2023-04-30,0,NULL,NULL,141,NULL,NULL,2075600,25225,141
2023-05-01,5,NULL,NULL,291,NULL,NULL,2075891,25230,291
2023-05-02,4,NULL,NULL,222,NULL,NULL,2076113,25234,222
2023-05-03,2,NULL,NULL,212,NULL,NULL,2076325,25236,212
2023-05-04,5,NULL,NULL,217,NULL,NULL,2076542,25241,217
2023-05-05,0,NULL,NULL,196,NULL,NULL,2076738,25241,196
2023-05-06,0,NULL,NULL,116,NULL,NULL,2076854,25241,116
2023-05-07,1,NULL,NULL,145,NULL,NULL,2076999,25242,145
2023-05-08,3,NULL,NULL,239,NULL,NULL,2077238,25245,239
2023-05-09,3,NULL,NULL,218,NULL,NULL,2077456,25248,218
2023-05-10,0,NULL,NULL,225,NULL,NULL,2077681,25248,225
2023-05-11,2,NULL,NULL,156,NULL,NULL,2077837,25250,156
2023-05-12,1,NULL,NULL,142,NULL,NULL,2077979,25251,142
2023-05-13,3,NULL,NULL,99,NULL,NULL,2078078,25254,99
2023-05-14,2,NULL,NULL,81,NULL,NULL,2078159,25256,81
2023-05-15,3,NULL,NULL,207,NULL,NULL,2078366,25259,207
2023-05-16,4,NULL,NULL,145,NULL,NULL,2078511,25263,145
2023-05-17,1,NULL,NULL,147,NULL,NULL,2078658,25264,147
2023-05-18,3,NULL,NULL,133,NULL,NULL,2078791,25267,133
2023-05-19,0,NULL,NULL,125,NULL,NULL,2078916,25267,125
2023-05-20,2,NULL,NULL,95,NULL,NULL,2079011,25269,95
2023-05-21,3,NULL,NULL,78,NULL,NULL,2079089,25272,78
2023-05-22,0,NULL,NULL,156,NULL,NULL,2079245,25272,156
2023-05-23,2,NULL,NULL,139,NULL,NULL,2079384,25274,139
2023-05-24,0,NULL,NULL,103,NULL,NULL,2079487,25274,103
2023-05-25,1,NULL,NULL,109,NULL,NULL,2079596,25275,109
2023-05-26,0,NULL,NULL,97,NULL,NULL,2079693,25275,97
2023-05-27,1,NULL,NULL,75,NULL,NULL,2079768,25276,75
2023-05-28,1,NULL,NULL,72,NULL,NULL,2079840,25277,72
2023-05-29,1,NULL,NULL,99,NULL,NULL,2079939,25278,99
2023-05-30,1,NULL,NULL,150,NULL,NULL,2080089,25279,150
2023-05-31,3,NULL,NULL,160,NULL,NULL,2080249,25282,160
2023-06-01,3,NULL,NULL,119,NULL,NULL,2080368,25285,119
2023-06-02,2,NULL,NULL,88,NULL,NULL,2080456,25287,88
2023-06-03,1,NULL,NULL,51,NULL,NULL,2080507,25288,51
2023-06-04,2,NULL,NULL,56,NULL,NULL,2080563,25290,56
2023-06-05,1,NULL,NULL,114,NULL,NULL,2080677,25291,114
2023-06-06,3,NULL,NULL,84,NULL,NULL,2080761,25294,84
2023-06-07,5,NULL,NULL,92,NULL,NULL,2080853,25299,92
2023-06-08,2,NULL,NULL,78,NULL,NULL,2080931,25301,78
2023-06-09,1,NULL,NULL,82,NULL,NULL,2081013,25302,82
2023-06-10,1,NULL,NULL,64,NULL,NULL,2081077,25303,64
2023-06-11,6,NULL,NULL,45,NULL,NULL,2081122,25309,45
2023-06-12,4,NULL,NULL,82,NULL,NULL,2081204,25313,82
2023-06-13,1,NULL,NULL,91,NULL,NULL,2081295,25314,91
2023-06-14,0,NULL,NULL,78,NULL,NULL,2081373,25314,78
2023-06-15,0,NULL,NULL,83,NULL,NULL,2081456,25314,83
2023-06-16,1,NULL,NULL,96,NULL,NULL,2081552,25315,96
2023-06-17,1,NULL,NULL,48,NULL,NULL,2081600,25316,48
2023-06-18,1,NULL,NULL,75,NULL,NULL,2081675,25317,75
2023-06-19,1,NULL,NULL,99,NULL,NULL,2081774,25318,99
2023-06-20,2,NULL,NULL,108,NULL,NULL,2081882,25320,108
2023-06-21,1,NULL,NULL,87,NULL,NULL,2081969,25321,87
2023-06-22,3,NULL,NULL,78,NULL,NULL,2082047,25324,78
2023-06-23,1,NULL,NULL,70,NULL,NULL,2082117,25325,70
2023-06-24,0,NULL,NULL,44,NULL,NULL,2082161,25325,44
2023-06-25,0,NULL,NULL,39,NULL,NULL,2082200,25325,39
2023-06-26,3,NULL,NULL,119,NULL,NULL,2082319,25328,119
2023-06-27,0,NULL,NULL,95,NULL,NULL,2082414,25328,95
2023-06-28,2,NULL,NULL,96,NULL,NULL,2082510,25330,96
2023-06-29,2,NULL,NULL,85,NULL,NULL,2082595,25332,85
2023-06-30,0,NULL,NULL,77,NULL,NULL,2082672,25332,77
2023-07-01,0,NULL,NULL,38,NULL,NULL,2082710,25332,38
2023-07-02,0,NULL,NULL,56,NULL,NULL,2082766,25332,56
2023-07-03,1,NULL,NULL,83,NULL,NULL,2082849,25333,83
2023-07-04,2,NULL,NULL,54,NULL,NULL,2082903,25335,54
2023-07-05,1,NULL,NULL,96,NULL,NULL,2082999,25336,96
2023-07-06,3,NULL,NULL,97,NULL,NULL,2083096,25339,97
2023-07-07,1,NULL,NULL,84,NULL,NULL,2083180,25340,84
2023-07-08,0,NULL,NULL,68,NULL,NULL,2083248,25340,68
2023-07-09,1,NULL,NULL,64,NULL,NULL,2083312,25341,64
2023-07-10,1,NULL,NULL,126,NULL,NULL,2083438,25342,126
2023-07-11,0,NULL,NULL,99,NULL,NULL,2083537,25342,99
2023-07-12,0,NULL,NULL,134,NULL,NULL,2083671,25342,134
2023-07-13,2,NULL,NULL,119,NULL,NULL,2083790,25344,119
2023-07-14,0,NULL,NULL,109,NULL,NULL,2083899,25344,109
2023-07-15,1,NULL,NULL,70,NULL,NULL,2083969,25345,70
2023-07-16,0,NULL,NULL,77,NULL,NULL,2084046,25345,77
2023-07-17,1,NULL,NULL,135,NULL,NULL,2084181,25346,135
2023-07-18,0,NULL,NULL,119,NULL,NULL,2084300,25346,119
2023-07-19,1,NULL,NULL,146,NULL,NULL,2084446,25347,146
2023-07-20,1,NULL,NULL,120,NULL,NULL,2084566,25348,120
2023-07-21,0,NULL,NULL,132,NULL,NULL,2084698,25348,132
2023-07-22,1,NULL,NULL,85,NULL,NULL,2084783,25349,85
2023-07-23,2,NULL,NULL,94,NULL,NULL,2084877,25351,94
2023-07-24,1,NULL,NULL,187,NULL,NULL,2085064,25352,187
2023-07-25,1,NULL,NULL,161,NULL,NULL,2085225,25353,161
2023-07-26,2,NULL,NULL,208,NULL,NULL,2085433,25355,208
2023-07-27,0,NULL,NULL,158,NULL,NULL,2085591,25355,158
2023-07-28,1,NULL,NULL,173,NULL,NULL,2085764,25356,173
2023-07-29,1,NULL,NULL,111,NULL,NULL,2085875,25357,111
2023-07-30,0,NULL,NULL,120,NULL,NULL,2085995,25357,120
2023-07-31,1,NULL,NULL,227,NULL,NULL,2086222,25358,227
2023-08-01,2,NULL,NULL,193,NULL,NULL,2086415,25360,193
2023-08-02,1,NULL,NULL,396,NULL,NULL,2086811,25361,396
2023-08-03,0,NULL,NULL,308,NULL,NULL,2087119,25361,308
2023-08-04,0,NULL,NULL,288,NULL,NULL,2087407,25361,288
2023-08-05,1,NULL,NULL,172,NULL,NULL,2087579,25362,172
2023-08-06,1,NULL,NULL,168,NULL,NULL,2087747,25363,168
2023-08-07,1,NULL,NULL,343,NULL,NULL,2088090,25364,343
2023-08-08,0,NULL,NULL,358,NULL,NULL,2088448,25364,358
2023-08-09,1,NULL,NULL,350,NULL,NULL,2088798,25365,350
2023-08-10,0,NULL,NULL,378,NULL,NULL,2089176,25365,378
2023-08-11,1,NULL,NULL,323,NULL,NULL,2089499,25366,323
2023-08-12,0,NULL,NULL,227,NULL,NULL,2089726,25366,227
2023-08-13,0,NULL,NULL,239,NULL,NULL,2089965,25366,239
2023-08-14,4,NULL,NULL,496,NULL,NULL,2090461,25370,496
2023-08-15,1,NULL,NULL,536,NULL,NULL,2090997,25371,536
2023-08-16,2,NULL,NULL,486,NULL,NULL,2091483,25373,486
2023-08-17,3,NULL,NULL,492,NULL,NULL,2091975,25376,492
2023-08-18,2,NULL,NULL,482,NULL,NULL,2092457,25378,482
2023-08-19,2,NULL,NULL,327,NULL,NULL,2092784,25380,327
2023-08-20,0,NULL,NULL,343,NULL,NULL,2093127,25380,343
2023-08-21,1,NULL,NULL,662,NULL,NULL,2093789,25381,662
2023-08-22,3,NULL,NULL,545,NULL,NULL,2094334,25384,545
2023-08-23,1,NULL,NULL,590,NULL,NULL,2094924,25385,590
2023-08-24,1,NULL,NULL,839,NULL,NULL,2095763,25386,839
2023-08-25,4,NULL,NULL,636,NULL,NULL,2096399,25390,636
2023-08-26,2,NULL,NULL,378,NULL,NULL,2096777,25392,378
2023-08-27,2,NULL,NULL,370,NULL,NULL,2097147,25394,370
2023-08-28,2,NULL,NULL,800,NULL,NULL,2097947,25396,800
2023-08-29,2,NULL,NULL,811,NULL,NULL,2098758,25398,811
2023-08-30,5,NULL,NULL,715,NULL,NULL,2099473,25403,715
2023-08-31,4,NULL,NULL,657,NULL,NULL,2100130,25407,657
2023-09-01,3,NULL,NULL,486,NULL,NULL,2100616,25410,486
2023-09-02,0,NULL,NULL,296,NULL,NULL,2100912,25410,296
2023-09-03,4,NULL,NULL,383,NULL,NULL,2101295,25414,383
2023-09-04,3,NULL,NULL,541,NULL,NULL,2101836,25417,541
2023-09-05,4,NULL,NULL,673,NULL,NULL,2102509,25421,673
2023-09-06,2,NULL,NULL,611,NULL,NULL,2103120,25423,611
2023-09-07,4,NULL,NULL,568,NULL,NULL,2103688,25427,568
2023-09-08,3,NULL,NULL,514,NULL,NULL,2104202,25430,514
2023-09-09,1,NULL,NULL,261,NULL,NULL,2104463,25431,261
2023-09-10,3,NULL,NULL,288,NULL,NULL,2104751,25434,288
2023-09-11,0,NULL,NULL,551,NULL,NULL,2105302,25434,551
2023-09-12,5,NULL,NULL,493,NULL,NULL,2105795,25439,493
2023-09-13,5,NULL,NULL,489,NULL,NULL,2106284,25444,489
2023-09-14,4,NULL,NULL,427,NULL,NULL,2106711,25448,427
2023-09-15,2,NULL,NULL,371,NULL,NULL,2107082,25450,371
2023-09-16,5,NULL,NULL,256,NULL,NULL,2107338,25455,256
2023-09-17,2,NULL,NULL,263,NULL,NULL,2107601,25457,263
2023-09-18,3,NULL,NULL,458,NULL,NULL,2108059,25460,458
2023-09-19,2,NULL,NULL,455,NULL,NULL,2108514,25462,455
2023-09-20,4,NULL,NULL,419,NULL,NULL,2108933,25466,419
2023-09-21,5,NULL,NULL,417,NULL,NULL,2109350,25471,417
2023-09-22,6,NULL,NULL,378,NULL,NULL,2109728,25477,378
2023-09-23,4,NULL,NULL,243,NULL,NULL,2109971,25481,243
2023-09-24,5,NULL,NULL,248,NULL,NULL,2110219,25486,248
2023-09-25,5,NULL,NULL,484,NULL,NULL,2110703,25491,484
2023-09-26,1,NULL,NULL,405,NULL,NULL,2111108,25492,405
2023-09-27,10,NULL,NULL,437,NULL,NULL,2111545,25502,437
2023-09-28,4,NULL,NULL,401,NULL,NULL,2111946,25506,401
2023-09-29,3,NULL,NULL,337,NULL,NULL,2112283,25509,337
2023-09-30,1,NULL,NULL,215,NULL,NULL,2112498,25510,215
2023-10-01,6,NULL,NULL,215,NULL,NULL,2112713,25516,215
2023-10-02,4,NULL,NULL,425,NULL,NULL,2113138,25520,425
2023-10-03,1,NULL,NULL,395,NULL,NULL,2113533,25521,395
2023-10-04,5,NULL,NULL,405,NULL,NULL,2113938,25526,405
2023-10-05,6,NULL,NULL,336,NULL,NULL,2114274,25532,336
2023-10-06,1,NULL,NULL,289,NULL,NULL,2114563,25533,289
2023-10-07,7,NULL,NULL,183,NULL,NULL,2114746,25540,183
2023-10-08,3,NULL,NULL,180,NULL,NULL,2114926,25543,180
2023-10-09,3,NULL,NULL,360,NULL,NULL,2115286,25546,360
2023-10-10,4,NULL,NULL,380,NULL,NULL,2115666,25550,380
2023-10-11,4,NULL,NULL,368,NULL,NULL,2116034,25554,368
2023-10-12,0,NULL,NULL,389,NULL,NULL,2116423,25554,389
2023-10-13,2,NULL,NULL,376,NULL,NULL,2116799,25556,376
2023-10-14,3,NULL,NULL,230,NULL,NULL,2117029,25559,230
2023-10-15,3,NULL,NULL,252,NULL,NULL,2117281,25562,252
2023-10-16,4,NULL,NULL,451,NULL,NULL,2117732,25566,451
2023-10-17,3,NULL,NULL,499,NULL,NULL,2118231,25569,499
2023-10-18,0,NULL,NULL,419,NULL,NULL,2118650,25569,419
2023-10-19,1,NULL,NULL,450,NULL,NULL,2119100,25570,450
2023-10-20,1,NULL,NULL,432,NULL,NULL,2119532,25571,432
2023-10-21,3,NULL,NULL,230,NULL,NULL,2119762,25574,230
2023-10-22,5,NULL,NULL,243,NULL,NULL,2120005,25579,243
2023-10-23,2,NULL,NULL,445,NULL,NULL,2120450,25581,445
2023-10-24,7,NULL,NULL,434,NULL,NULL,2120884,25588,434
2023-10-25,1,NULL,NULL,536,NULL,NULL,2121420,25589,536
2023-10-26,4,NULL,NULL,482,NULL,NULL,2121902,25593,482
2023-10-27,5,NULL,NULL,442,NULL,NULL,2122344,25598,442
2023-10-28,2,NULL,NULL,267,NULL,NULL,2122611,25600,267
2023-10-29,3,NULL,NULL,272,NULL,NULL,2122883,25603,272
2023-10-30,3,NULL,NULL,429,NULL,NULL,2123312,25606,429
2023-10-31,5,NULL,NULL,436,NULL,NULL,2123748,25611,436
2023-11-01,6,NULL,NULL,504,NULL,NULL,2124252,25617,504
2023-11-02,1,NULL,NULL,512,NULL,NULL,2124764,25618,512
2023-11-03,4,NULL,NULL,455,NULL,NULL,2125219,25622,455
2023-11-04,2,NULL,NULL,292,NULL,NULL,2125511,25624,292
2023-11-05,6,NULL,NULL,334,NULL,NULL,2125845,25630,334
2023-11-06,5,NULL,NULL,672,NULL,NULL,2126517,25635,672
2023-11-07,6,NULL,NULL,652,NULL,NULL,2127169,25641,652
2023-11-08,4,NULL,NULL,692,NULL,NULL,2127861,25645,692
2023-11-09,6,NULL,NULL,634,NULL,NULL,2128495,25651,634
2023-11-10,1,NULL,NULL,353,NULL,NULL,2128848,25652,353
2023-11-11,1,NULL,NULL,237,NULL,NULL,2129085,25653,237
2023-11-12,0,NULL,NULL,248,NULL,NULL,2129333,25653,248
2023-11-13,1,NULL,NULL,492,NULL,NULL,2129825,25654,492
2023-11-14,0,NULL,NULL,299,NULL,NULL,2130124,25654,299
