DATE,COVID_DEATHS,DAILY_DELTA_DEATHS,DAILY_BASE_DEATHS,COVID_COUNT,DAILY_DELTA_CASES,DAILY_BASE_CASES,COVID_COUNT_CUMSUM,COVID_DEATHS_CUMSUM,COVID_COUNT_BY_SPECIMEN_COLLECTION_DATE
2/26/2020,0,0,0,3,0,3,3,0,3
2/27/2020,0,0,0,0,0,0,3,0,0
2/28/2020,0,0,0,0,0,0,3,0,0
2/29/2020,0,0,0,1,0,1,4,0,1
3/1/2020,0,0,0,0,0,0,4,0,0
3/2/2020,0,0,0,0,0,0,4,0,0
3/3/2020,0,0,0,0,0,0,4,0,0
3/4/2020,0,0,0,0,0,0,4,0,0
3/5/2020,0,0,0,0,0,0,4,0,0
3/6/2020,0,0,0,1,0,1,5,0,1
3/7/2020,0,0,0,1,0,1,6,0,1
3/8/2020,0,0,0,2,0,2,8,0,2
3/9/2020,0,0,0,7,0,7,15,0,7
3/10/2020,0,0,0,1,0,1,16,0,1
3/11/2020,0,0,0,7,0,7,23,0,7
3/12/2020,0,0,0,17,0,17,40,0,17
3/13/2020,0,0,0,22,0,22,62,0,22
3/14/2020,0,0,0,28,0,28,90,0,28
3/15/2020,0,0,0,23,0,23,113,0,23
3/16/2020,1,0,1,84,0,84,197,1,84
3/17/2020,2,0,2,93,0,93,290,3,93
3/18/2020,1,0,1,115,0,115,405,4,115
3/19/2020,0,0,0,142,0,142,547,4,142
3/20/2020,6,0,6,217,0,217,764,10,217
3/21/2020,4,0,4,125,0,125,889,14,125
3/22/2020,4,0,4,120,0,120,1009,18,120
3/23/2020,5,0,5,314,0,314,1323,23,314
3/24/2020,5,0,5,367,0,367,1690,28,367
3/25/2020,5,0,5,382,0,382,2072,33,382
3/26/2020,9,0,9,411,0,411,2483,42,411
3/27/2020,3,0,3,437,0,437,2920,45,438
3/28/2020,13,0,13,309,0,309,3229,58,308
3/29/2020,17,0,17,265,0,265,3494,75,265
3/30/2020,14,0,14,443,0,443,3937,89,443
3/31/2020,23,0,23,483,0,483,4420,112,484
4/1/2020,21,0,21,444,0,444,4864,133,443
4/2/2020,21,0,21,485,0,485,5349,154,486
4/3/2020,32,0,32,442,0,442,5791,186,441
4/4/2020,25,0,25,293,0,293,6084,211,293
4/5/2020,32,0,32,248,0,248,6332,243,248
4/6/2020,25,0,25,540,0,540,6872,268,540
4/7/2020,38,0,38,546,0,546,7418,306,546
4/8/2020,29,0,29,564,0,564,7982,335,564
4/9/2020,36,0,36,426,0,426,8408,371,427
4/10/2020,26,0,26,458,0,458,8866,397,457
4/11/2020,23,0,23,263,0,263,9129,420,263
4/12/2020,27,0,27,171,0,171,9300,447,171
4/13/2020,35,0,35,614,0,614,9914,482,614
4/14/2020,47,0,47,632,0,632,10546,529,632
4/15/2020,38,0,38,576,0,576,11122,567,576
4/16/2020,34,0,34,616,0,616,11738,601,616
4/17/2020,35,0,35,650,0,650,12388,636,650
4/18/2020,28,0,28,283,0,283,12671,664,283
4/19/2020,39,0,39,257,0,257,12928,703,257
4/20/2020,37,0,37,729,0,729,13657,740,729
4/21/2020,49,0,49,648,0,648,14305,789,648
4/22/2020,50,0,50,605,0,605,14910,839,605
4/23/2020,38,0,38,1426,0,1426,16336,877,1426
4/24/2020,36,0,36,802,0,802,17138,913,802
4/25/2020,42,0,42,378,0,378,17516,955,378
4/26/2020,35,0,35,232,0,232,17748,990,232
4/27/2020,44,0,44,717,0,717,18465,1034,717
4/28/2020,36,0,36,750,0,750,19215,1070,750
4/29/2020,44,0,44,702,0,702,19917,1114,702
4/30/2020,45,0,45,680,0,680,20597,1159,680
5/1/2020,37,0,37,872,0,872,21469,1196,872
5/2/2020,44,0,44,441,0,441,21910,1240,441
5/3/2020,37,0,37,308,0,308,22218,1277,309
5/4/2020,40,0,40,698,0,698,22916,1317,697
5/5/2020,37,0,37,753,0,753,23669,1354,753
5/6/2020,42,0,42,539,0,539,24208,1396,539
5/7/2020,37,0,37,619,0,619,24827,1433,620
5/8/2020,28,0,28,565,0,565,25392,1461,564
5/9/2020,34,0,34,313,0,313,25705,1495,313
5/10/2020,33,0,33,142,0,142,25847,1528,142
5/11/2020,41,0,41,621,0,621,26468,1569,621
5/12/2020,38,0,38,698,0,698,27166,1607,698
5/13/2020,27,0,27,593,0,593,27759,1634,593
5/14/2020,44,0,44,524,0,524,28283,1678,524
5/15/2020,33,0,33,867,0,867,29150,1711,867
5/16/2020,30,0,30,245,0,245,29395,1741,245
5/17/2020,30,0,30,196,0,196,29591,1771,196
5/18/2020,41,0,41,699,0,699,30290,1812,699
5/19/2020,31,0,31,590,0,590,30880,1843,591
5/20/2020,33,0,33,579,0,579,31459,1876,578
5/21/2020,39,0,39,651,0,651,32110,1915,651
5/22/2020,18,0,18,542,0,542,32652,1933,542
5/23/2020,25,0,25,209,0,209,32861,1958,209
5/24/2020,15,0,15,157,0,157,33018,1973,157
5/25/2020,23,0,23,175,0,175,33193,1996,175
5/26/2020,21,0,21,655,0,655,33848,2017,655
5/27/2020,15,0,15,453,0,453,34301,2032,453
5/28/2020,19,0,19,496,0,496,34797,2051,496
5/29/2020,22,0,22,478,0,478,35275,2073,478
5/30/2020,23,0,23,183,0,183,35458,2096,183
5/31/2020,17,0,17,134,0,134,35592,2113,134
6/1/2020,19,0,19,611,0,611,36203,2132,611
6/2/2020,21,0,21,426,0,426,36629,2153,426
6/3/2020,28,0,28,408,0,408,37037,2181,408
6/4/2020,23,0,23,462,0,462,37499,2204,462
6/5/2020,21,0,21,433,0,433,37932,2225,434
6/6/2020,10,0,10,158,0,158,38090,2235,157
6/7/2020,14,0,14,154,0,154,38244,2249,154
6/8/2020,16,0,16,688,0,688,38932,2265,688
6/9/2020,26,0,26,455,0,455,39387,2291,455
6/10/2020,18,0,18,456,0,456,39843,2309,456
6/11/2020,15,0,15,402,0,402,40245,2324,402
6/12/2020,16,0,16,380,0,380,40625,2340,380
6/13/2020,13,0,13,168,0,168,40793,2353,168
6/14/2020,20,0,20,175,0,175,40968,2373,175
6/15/2020,15,0,15,469,0,469,41437,2388,469
6/16/2020,15,0,15,370,0,370,41807,2403,370
6/17/2020,18,0,18,429,0,429,42236,2421,429
6/18/2020,26,0,26,394,0,394,42630,2447,394
6/19/2020,11,0,11,366,0,366,42996,2458,366
6/20/2020,10,0,10,206,0,206,43202,2468,206
6/21/2020,12,0,12,134,0,134,43336,2480,134
6/22/2020,16,0,16,596,0,596,43932,2496,596
6/23/2020,5,0,5,480,0,480,44412,2501,480
6/24/2020,10,0,10,457,0,457,44869,2511,457
6/25/2020,12,0,12,466,0,466,45335,2523,466
6/26/2020,12,0,12,544,0,544,45879,2535,544
6/27/2020,12,0,12,254,0,254,46133,2547,254
6/28/2020,9,0,9,218,0,218,46351,2556,218
6/29/2020,8,0,8,640,0,640,46991,2564,640
6/30/2020,10,0,10,592,0,592,47583,2574,592
7/1/2020,12,0,12,567,0,567,48150,2586,567
7/2/2020,9,0,9,667,0,667,48817,2595,667
7/3/2020,11,0,11,325,0,325,49142,2606,325
7/4/2020,7,0,7,174,0,174,49316,2613,174
7/5/2020,12,0,12,275,0,275,49591,2625,275
7/6/2020,16,0,16,913,0,913,50504,2641,913
7/7/2020,9,0,9,841,0,841,51345,2650,841
7/8/2020,8,0,8,735,0,735,52080,2658,735
7/9/2020,11,0,11,746,0,746,52826,2669,746
7/10/2020,7,0,7,746,0,746,53572,2676,747
7/11/2020,11,0,11,370,0,370,53942,2687,369
7/12/2020,12,0,12,335,0,335,54277,2699,335
7/13/2020,9,0,9,1022,0,1022,55299,2708,1022
7/14/2020,6,0,6,946,0,946,56245,2714,946
7/15/2020,11,0,11,892,0,892,57137,2725,892
7/16/2020,10,0,10,988,0,988,58125,2735,988
7/17/2020,9,0,9,954,0,954,59079,2744,954
7/18/2020,9,0,9,377,0,377,59456,2753,377
7/19/2020,10,0,10,299,0,299,59755,2763,299
7/20/2020,14,0,14,1031,0,1031,60786,2777,1031
7/21/2020,9,0,9,977,0,977,61763,2786,977
7/22/2020,13,0,13,981,0,981,62744,2799,981
7/23/2020,10,0,10,999,0,999,63743,2809,999
7/24/2020,11,0,11,906,0,906,64649,2820,906
7/25/2020,11,0,11,399,0,399,65048,2831,399
7/26/2020,10,0,10,280,0,280,65328,2841,280
7/27/2020,4,0,4,1050,0,1050,66378,2845,1050
7/28/2020,6,0,6,964,0,964,67342,2851,964
7/29/2020,21,0,21,1053,0,1053,68395,2872,1053
7/30/2020,9,0,9,842,0,842,69237,2881,842
7/31/2020,11,0,11,957,0,957,70194,2892,957
8/1/2020,13,0,13,424,0,424,70618,2905,424
8/2/2020,9,0,9,300,0,300,70918,2914,300
8/3/2020,9,0,9,1189,0,1189,72107,2923,1189
8/4/2020,11,0,11,1127,0,1127,73234,2934,1127
8/5/2020,5,0,5,1081,0,1081,74315,2939,1081
8/6/2020,15,0,15,1069,0,1069,75384,2954,1069
8/7/2020,14,0,14,1063,0,1063,76447,2968,1063
8/8/2020,12,0,12,408,0,408,76855,2980,408
8/9/2020,7,0,7,320,0,320,77175,2987,320
8/10/2020,16,0,16,1324,0,1324,78499,3003,1324
8/11/2020,13,0,13,1021,0,1021,79520,3016,1021
8/12/2020,15,0,15,1114,0,1114,80634,3031,1114
8/13/2020,14,0,14,933,0,933,81567,3045,933
8/14/2020,17,0,17,1071,0,1071,82638,3062,1071
8/15/2020,12,0,12,394,0,394,83032,3074,394
8/16/2020,12,0,12,342,0,342,83374,3086,342
8/17/2020,22,0,22,1271,0,1271,84645,3108,1271
8/18/2020,5,0,5,1156,0,1156,85801,3113,1156
8/19/2020,17,0,17,1110,0,1110,86911,3130,1110
8/20/2020,16,0,16,989,0,989,87900,3146,989
8/21/2020,8,0,8,970,0,970,88870,3154,970
8/22/2020,15,0,15,440,0,440,89310,3169,440
8/23/2020,12,0,12,363,0,363,89673,3181,363
8/24/2020,14,0,14,1273,0,1273,90946,3195,1274
8/25/2020,11,0,11,1123,0,1123,92069,3206,1122
8/26/2020,4,0,4,1200,0,1200,93269,3210,1200
8/27/2020,16,0,16,1076,0,1076,94345,3226,1076
8/28/2020,9,0,9,1017,0,1017,95362,3235,1017
8/29/2020,12,0,12,478,0,478,95840,3247,478
8/30/2020,9,0,9,324,0,324,96164,3256,324
8/31/2020,13,0,13,1349,0,1349,97513,3269,1349
9/1/2020,7,0,7,1081,0,1081,98594,3276,1081
9/2/2020,10,0,10,1104,0,1104,99698,3286,1104
9/3/2020,6,0,6,1069,0,1069,100767,3292,1069
9/4/2020,14,0,14,963,0,963,101730,3306,963
9/5/2020,11,0,11,438,0,438,102168,3317,438
9/6/2020,14,0,14,284,0,284,102452,3331,284
9/7/2020,11,0,11,369,0,369,102821,3342,369
9/8/2020,16,0,16,1358,0,1358,104179,3358,1358
9/9/2020,13,0,13,1063,0,1063,105242,3371,1063
9/10/2020,12,0,12,988,0,988,106230,3383,988
9/11/2020,12,0,12,994,0,994,107224,3395,994
9/12/2020,4,0,4,356,0,356,107580,3399,356
9/13/2020,17,0,17,301,0,301,107881,3416,301
9/14/2020,14,0,14,1212,0,1212,109093,3430,1212
9/15/2020,12,0,12,1013,0,1013,110106,3442,1013
9/16/2020,8,0,8,919,0,919,111025,3450,919
9/17/2020,15,0,15,854,0,854,111879,3465,854
9/18/2020,12,0,12,799,0,799,112678,3477,799
9/19/2020,10,0,10,382,0,382,113060,3487,382
9/20/2020,7,0,7,290,0,290,113350,3494,290
9/21/2020,11,0,11,1209,0,1209,114559,3505,1209
9/22/2020,15,0,15,1157,0,1157,115716,3520,1157
9/23/2020,17,0,17,1155,0,1155,116871,3537,1155
9/24/2020,13,0,13,1095,0,1095,117966,3550,1095
9/25/2020,13,0,13,991,0,991,118957,3563,991
9/26/2020,24,0,24,513,0,513,119470,3587,513
9/27/2020,12,0,12,430,0,430,119900,3599,430
9/28/2020,20,0,20,1744,0,1744,121644,3619,1744
9/29/2020,19,0,19,1483,0,1483,123127,3638,1483
9/30/2020,13,0,13,1330,0,1330,124457,3651,1330
10/1/2020,19,0,19,1313,0,1313,125770,3670,1314
10/2/2020,19,0,19,1295,0,1295,127065,3689,1294
10/3/2020,24,0,24,611,0,611,127676,3713,611
10/4/2020,16,0,16,566,0,566,128242,3729,567
10/5/2020,14,0,14,2049,0,2049,130291,3743,2049
10/6/2020,15,0,15,1791,0,1791,132082,3758,1790
10/7/2020,19,0,19,1876,0,1876,133958,3777,1876
10/8/2020,23,0,23,1982,0,1982,135940,3800,1982
10/9/2020,25,0,25,1935,0,1935,137875,3825,1935
10/10/2020,17,0,17,952,0,952,138827,3842,952
10/11/2020,21,0,21,774,0,774,139601,3863,774
10/12/2020,23,0,23,2517,0,2517,142118,3886,2517
10/13/2020,29,0,29,2482,0,2482,144600,3915,2482
10/14/2020,20,0,20,2272,0,2272,146872,3935,2272
10/15/2020,35,0,35,2211,0,2211,149083,3970,2211
10/16/2020,42,0,42,2034,0,2034,151117,4012,2035
10/17/2020,24,0,24,1053,0,1053,152170,4036,1052
10/18/2020,30,0,30,809,0,809,152979,4066,809
10/19/2020,20,0,20,3264,0,3264,156243,4086,3265
10/20/2020,36,0,36,2775,0,2775,159018,4122,2774
10/21/2020,33,0,33,2794,0,2794,161812,4155,2795
10/22/2020,36,0,36,2936,0,2936,164748,4191,2935
10/23/2020,28,0,28,2742,0,2742,167490,4219,2742
10/24/2020,25,0,25,1460,0,1460,168950,4244,1461
10/25/2020,30,0,30,1087,0,1087,170037,4274,1086
10/26/2020,41,0,41,4337,0,4337,174374,4315,4337
10/27/2020,41,0,41,3656,0,3656,178030,4356,3656
10/28/2020,35,0,35,3726,0,3726,181756,4391,3726
10/29/2020,39,0,39,3952,0,3952,185708,4430,3952
10/30/2020,50,0,50,3553,0,3553,189261,4480,3553
10/31/2020,35,0,35,1828,0,1828,191089,4515,1829
11/1/2020,40,0,40,1612,0,1612,192701,4555,1611
11/2/2020,43,0,43,5539,0,5539,198240,4598,5539
11/3/2020,42,0,42,5179,0,5179,203419,4640,5179
11/4/2020,52,0,52,6120,0,6120,209539,4692,6120
11/5/2020,40,0,40,6541,0,6541,216080,4732,6541
11/6/2020,57,0,57,6014,0,6014,222094,4789,6014
11/7/2020,49,0,49,3254,0,3254,225348,4838,3255
11/8/2020,61,0,61,2453,0,2453,227801,4899,2452
11/9/2020,44,0,44,9151,0,9151,236952,4943,9151
11/10/2020,61,0,61,8904,0,8904,245856,5004,8905
11/11/2020,59,0,59,6678,0,6678,252534,5063,6677
11/12/2020,41,0,41,8068,0,8068,260602,5104,8069
11/13/2020,46,0,46,6801,0,6801,267403,5150,6800
11/14/2020,52,0,52,3521,0,3521,270924,5202,3522
11/15/2020,70,0,70,2372,0,2372,273296,5272,2371
11/16/2020,62,0,62,9197,0,9197,282493,5334,9197
11/17/2020,83,0,83,8036,0,8036,290529,5417,8037
11/18/2020,74,0,74,7142,0,7142,297671,5491,7141
11/19/2020,78,0,78,7252,0,7252,304923,5569,7253
11/20/2020,72,0,72,6682,0,6682,311605,5641,6681
11/21/2020,69,0,69,3536,0,3536,315141,5710,3537
11/22/2020,78,0,78,2440,0,2440,317581,5788,2439
11/23/2020,88,0,88,8848,0,8848,326429,5876,8849
11/24/2020,82,0,82,7783,0,7783,334212,5958,7782
11/25/2020,84,0,84,6879,0,6879,341091,6042,6879
11/26/2020,95,0,95,1031,0,1031,342122,6137,1032
11/27/2020,86,0,86,5602,0,5602,347724,6223,5602
11/28/2020,73,0,73,3978,0,3978,351702,6296,3977
11/29/2020,81,0,81,2976,0,2976,354678,6377,2977
11/30/2020,84,0,84,10127,0,10127,364805,6461,10126
12/1/2020,87,0,87,8415,0,8415,373220,6548,8415
12/2/2020,100,0,100,7362,0,7362,380582,6648,7363
12/3/2020,90,0,90,7389,0,7389,387971,6738,7388
12/4/2020,99,0,99,6721,0,6721,394692,6837,6721
12/5/2020,97,0,97,3447,0,3447,398139,6934,3447
12/6/2020,90,0,90,2520,0,2520,400659,7024,2520
12/7/2020,95,0,95,9028,0,9028,409687,7119,9030
12/8/2020,111,0,111,7394,0,7394,417081,7230,7392
12/9/2020,105,0,105,6587,0,6587,423668,7335,6591
12/10/2020,108,0,108,6648,0,6648,430316,7443,6645
12/11/2020,110,0,110,5941,0,5941,436257,7553,5940
12/12/2020,97,0,97,3256,0,3256,439513,7650,3256
12/13/2020,87,0,87,2442,0,2442,441955,7737,2443
12/14/2020,107,0,107,8175,0,8175,450130,7844,8176
12/15/2020,95,0,95,6727,0,6727,456857,7939,6725
12/16/2020,94,0,94,5554,0,5554,462411,8033,5554
12/17/2020,115,0,115,5640,0,5640,468051,8148,5640
12/18/2020,110,0,110,5247,0,5247,473298,8258,5249
12/19/2020,96,0,96,3067,0,3067,476365,8354,3065
12/20/2020,88,0,88,2262,0,2262,478627,8442,2262
12/21/2020,107,0,107,7315,0,7315,485942,8549,7315
12/22/2020,84,0,84,5743,0,5743,491685,8633,5743
12/23/2020,94,0,94,5182,0,5182,496867,8727,5182
12/24/2020,79,0,79,3116,0,3116,499983,8806,3116
12/25/2020,91,0,91,612,0,612,500595,8897,612
12/26/2020,95,0,95,3767,0,3767,504362,8992,3767
12/27/2020,95,0,95,2802,0,2802,507164,9087,2803
12/28/2020,105,0,105,7917,0,7917,515081,9192,7918
12/29/2020,125,0,125,6617,0,6617,521698,9317,6617
12/30/2020,103,0,103,5915,0,5915,527613,9420,5914
12/31/2020,79,0,79,4885,0,4885,532498,9499,4885
1/1/2021,86,0,86,1234,0,1234,533732,9585,1238
1/2/2021,99,0,99,4666,0,4666,538398,9684,4665
1/3/2021,74,0,74,3028,0,3028,541426,9758,3031
1/4/2021,118,0,118,8641,0,8641,550067,9876,8653
1/5/2021,72,0,72,6585,0,6585,556652,9948,6569
1/6/2021,90,0,90,5473,0,5473,562125,10038,5487
1/7/2021,82,0,82,5255,0,5255,567380,10120,5242
1/8/2021,68,0,68,4450,0,4450,571830,10188,4451
1/9/2021,78,0,78,2706,0,2706,574536,10266,2701
1/10/2021,62,0,62,2198,0,2198,576734,10328,2202
1/11/2021,77,0,77,5551,0,5551,582285,10405,5549
1/12/2021,65,0,65,4439,0,4439,586724,10470,4437
1/13/2021,73,0,73,3838,0,3838,590562,10543,3839
1/14/2021,75,0,75,3815,0,3815,594377,10618,3814
1/15/2021,70,0,70,3267,0,3267,597644,10688,3267
1/16/2021,77,0,77,2041,0,2041,599685,10765,2041
1/17/2021,73,0,73,1718,0,1718,601403,10838,1718
1/18/2021,74,0,74,3731,0,3731,605134,10912,3732
1/19/2021,53,0,53,3577,0,3577,608711,10965,3576
1/20/2021,71,0,71,3130,0,3130,611841,11036,3130
1/21/2021,59,0,59,2956,0,2956,614797,11095,2956
1/22/2021,73,0,73,2674,0,2674,617471,11168,2674
1/23/2021,54,0,54,1551,0,1551,619022,11222,1551
1/24/2021,56,0,56,1224,0,1224,620246,11278,1225
1/25/2021,52,0,52,3261,0,3261,623507,11330,3260
1/26/2021,56,0,56,2490,0,2490,625997,11386,2491
1/27/2021,59,0,59,2286,0,2286,628283,11445,2285
1/28/2021,58,0,58,2179,0,2179,630462,11503,2180
1/29/2021,54,0,54,1996,0,1996,632458,11557,1995
1/30/2021,52,0,52,1161,0,1161,633619,11609,1162
1/31/2021,46,0,46,906,0,906,634525,11655,906
2/1/2021,49,0,49,2541,0,2541,637066,11704,2540
2/2/2021,54,0,54,2047,0,2047,639113,11758,2048
2/3/2021,53,0,53,1939,0,1939,641052,11811,1938
2/4/2021,43,0,43,1796,0,1796,642848,11854,1796
2/5/2021,32,0,32,1473,0,1473,644321,11886,1473
2/6/2021,29,0,29,981,0,981,645302,11915,981
2/7/2021,30,0,30,788,0,788,646090,11945,788
2/8/2021,26,0,26,1903,0,1903,647993,11971,1903
2/9/2021,36,0,36,1538,0,1538,649531,12007,1539
2/10/2021,31,0,31,1304,0,1304,650835,12038,1303
2/11/2021,21,0,21,1291,0,1291,652126,12059,1291
2/12/2021,29,0,29,1209,0,1209,653335,12088,1209
2/13/2021,21,0,21,707,0,707,654042,12109,707
2/14/2021,22,0,22,576,0,576,654618,12131,577
2/15/2021,31,0,31,1064,0,1064,655682,12162,1063
2/16/2021,25,0,25,699,0,699,656381,12187,699
2/17/2021,28,0,28,1283,0,1283,657664,12215,1283
2/18/2021,15,0,15,1109,0,1109,658773,12230,1111
2/19/2021,10,0,10,1005,0,1005,659778,12240,1004
2/20/2021,31,0,31,619,0,619,660397,12271,618
2/21/2021,21,0,21,535,0,535,660932,12292,535
2/22/2021,22,0,22,1267,0,1267,662199,12314,1268
2/23/2021,17,0,17,907,0,907,663106,12331,906
2/24/2021,19,0,19,932,0,932,664038,12350,932
2/25/2021,17,0,17,825,0,825,664863,12367,825
2/26/2021,15,0,15,743,0,743,665606,12382,743
2/27/2021,12,0,12,509,0,509,666115,12394,509
2/28/2021,16,0,16,406,0,406,666521,12410,406
3/1/2021,14,0,14,1008,0,1008,667529,12424,1008
3/2/2021,26,0,26,905,0,905,668434,12450,905
3/3/2021,11,0,11,827,0,827,669261,12461,827
3/4/2021,13,0,13,832,0,832,670093,12474,832
3/5/2021,17,0,17,763,0,763,670856,12491,763
3/6/2021,13,0,13,451,0,451,671307,12504,451
3/7/2021,13,0,13,424,0,424,671731,12517,424
3/8/2021,14,0,14,1072,0,1072,672803,12531,1072
3/9/2021,12,0,12,832,0,832,673635,12543,832
3/10/2021,16,0,16,885,0,885,674520,12559,885
3/11/2021,10,0,10,840,0,840,675360,12569,840
3/12/2021,15,0,15,773,0,773,676133,12584,773
3/13/2021,7,0,7,363,0,363,676496,12591,363
3/14/2021,7,0,7,473,0,473,676969,12598,474
3/15/2021,8,0,8,1137,0,1137,678106,12606,1136
3/16/2021,10,0,10,910,0,910,679016,12616,910
3/17/2021,8,0,8,860,0,860,679876,12624,860
3/18/2021,20,0,20,872,0,872,680748,12644,872
3/19/2021,9,0,9,847,0,847,681595,12653,847
3/20/2021,2,0,2,554,0,554,682149,12655,554
3/21/2021,10,0,10,492,0,492,682641,12665,492
3/22/2021,7,0,7,1197,0,1197,683838,12672,1197
3/23/2021,6,0,6,1064,0,1064,684902,12678,1064
3/24/2021,7,0,7,1067,0,1067,685969,12685,1067
3/25/2021,9,0,9,1012,0,1012,686981,12694,1012
3/26/2021,8,0,8,977,0,977,687958,12702,978
3/27/2021,8,0,8,642,0,642,688600,12710,641
3/28/2021,8,0,8,591,0,591,689191,12718,591
3/29/2021,5,0,5,1398,0,1398,690589,12723,1398
3/30/2021,10,0,10,1270,0,1270,691859,12733,1270
3/31/2021,10,0,10,1228,0,1228,693087,12743,1228
4/1/2021,9,0,9,1189,0,1189,694276,12752,1189
4/2/2021,6,0,6,1023,0,1023,695299,12758,1023
4/3/2021,7,0,7,713,0,713,696012,12765,713
4/4/2021,6,0,6,427,0,427,696439,12771,427
4/5/2021,4,0,4,1612,0,1612,698051,12775,1612
4/6/2021,5,0,5,1401,0,1401,699452,12780,1401
4/7/2021,9,0,9,1359,0,1359,700811,12789,1359
4/8/2021,7,0,7,1310,0,1310,702121,12796,1310
4/9/2021,9,0,9,1232,0,1232,703353,12805,1232
4/10/2021,8,0,8,789,0,789,704142,12813,789
4/11/2021,11,0,11,693,0,693,704835,12824,693
4/12/2021,11,0,11,1649,0,1649,706484,12835,1649
4/13/2021,16,0,16,1377,0,1377,707861,12851,1377
4/14/2021,4,0,4,1257,0,1257,709118,12855,1257
4/15/2021,6,0,6,1170,0,1170,710288,12861,1170
4/16/2021,12,0,12,1118,0,1118,711406,12873,1119
4/17/2021,7,0,7,665,0,665,712071,12880,664
4/18/2021,6,0,6,541,0,541,712612,12886,542
4/19/2021,6,0,6,1417,0,1417,714029,12892,1416
4/20/2021,7,0,7,1137,0,1137,715166,12899,1137
4/21/2021,8,0,8,1135,0,1135,716301,12907,1135
4/22/2021,4,0,4,1025,0,1025,717326,12911,1025
4/23/2021,6,0,6,1069,0,1069,718395,12917,1069
4/24/2021,9,0,9,634,0,634,719029,12926,634
4/25/2021,11,0,11,618,0,618,719647,12937,620
4/26/2021,8,0,8,1653,0,1653,721300,12945,1651
4/27/2021,10,0,10,1375,0,1375,722675,12955,1375
4/28/2021,9,0,9,1333,0,1333,724008,12964,1335
4/29/2021,8,0,8,1255,0,1255,725263,12972,1253
4/30/2021,10,0,10,1141,0,1141,726404,12982,1141
5/1/2021,7,0,7,651,0,651,727055,12989,651
5/2/2021,10,0,10,694,0,694,727749,12999,694
5/3/2021,7,0,7,1478,0,1478,729227,13006,1478
5/4/2021,7,0,7,1229,0,1229,730456,13013,1230
5/5/2021,11,0,11,1121,0,1121,731577,13024,1120
5/6/2021,10,0,10,984,0,984,732561,13034,984
5/7/2021,10,0,10,825,0,825,733386,13044,825
5/8/2021,9,0,9,572,0,572,733958,13053,572
5/9/2021,14,0,14,454,0,454,734412,13067,454
5/10/2021,5,0,5,1090,0,1090,735502,13072,1090
5/11/2021,10,0,10,886,0,886,736388,13082,886
5/12/2021,8,0,8,805,0,805,737193,13090,806
5/13/2021,12,0,12,789,0,789,737982,13102,789
5/14/2021,8,0,8,762,0,762,738744,13110,761
5/15/2021,11,0,11,447,0,447,739191,13121,447
5/16/2021,13,0,13,451,0,451,739642,13134,451
5/17/2021,8,0,8,1025,0,1025,740667,13142,1026
5/18/2021,5,0,5,850,0,850,741517,13147,849
5/19/2021,16,0,16,746,0,746,742263,13163,746
5/20/2021,9,0,9,671,0,671,742934,13172,671
5/21/2021,9,0,9,632,0,632,743566,13181,632
5/22/2021,13,0,13,366,0,366,743932,13194,366
5/23/2021,2,0,2,361,0,361,744293,13196,361
5/24/2021,9,0,9,729,0,729,745022,13205,730
5/25/2021,11,0,11,636,0,636,745658,13216,635
5/26/2021,12,0,12,505,0,505,746163,13228,505
5/27/2021,9,0,9,463,0,463,746626,13237,463
5/28/2021,11,0,11,386,0,386,747012,13248,386
5/29/2021,15,0,15,256,0,256,747268,13263,256
5/30/2021,8,0,8,229,0,229,747497,13271,229
5/31/2021,16,0,16,155,0,155,747652,13287,155
6/1/2021,8,0,8,536,0,536,748188,13295,536
6/2/2021,6,0,6,352,0,352,748540,13301,352
6/3/2021,10,0,10,383,0,383,748923,13311,383
6/4/2021,11,0,11,348,0,348,749271,13322,348
6/5/2021,7,0,7,216,0,216,749487,13329,217
6/6/2021,8,0,8,205,0,205,749692,13337,204
6/7/2021,6,0,6,357,0,357,750049,13343,357
6/8/2021,10,0,10,310,0,310,750359,13353,310
6/9/2021,6,0,6,300,0,300,750659,13359,300
6/10/2021,9,0,9,257,0,257,750916,13368,257
6/11/2021,7,0,7,232,0,232,751148,13375,232
6/12/2021,7,0,7,137,0,137,751285,13382,137
6/13/2021,8,0,8,134,0,134,751419,13390,134
6/14/2021,2,0,2,267,0,267,751686,13392,267
6/15/2021,8,0,8,236,0,236,751922,13400,236
6/16/2021,2,0,2,197,0,197,752119,13402,197
6/17/2021,10,0,10,203,0,203,752322,13412,203
6/18/2021,6,0,6,201,0,201,752523,13418,201
6/19/2021,4,0,4,123,0,123,752646,13422,123
6/20/2021,8,0,8,121,0,121,752767,13430,121
6/21/2021,4,0,4,264,0,264,753031,13434,264
6/22/2021,5,0,5,227,0,227,753258,13439,227
6/23/2021,7,0,7,228,0,228,753486,13446,228
6/24/2021,5,0,5,235,0,235,753721,13451,235
6/25/2021,5,0,5,217,0,217,753938,13456,217
6/26/2021,8,0,8,150,0,150,754088,13464,150
6/27/2021,2,0,2,130,0,130,754218,13466,130
6/28/2021,1,0,1,322,0,322,754540,13467,322
6/29/2021,4,0,4,264,0,264,754804,13471,264
6/30/2021,8,0,8,272,0,272,755076,13479,272
7/1/2021,9,0,9,293,0,293,755369,13488,293
7/2/2021,5,0,5,269,0,269,755638,13493,269
7/3/2021,3,0,3,194,0,194,755832,13496,194
7/4/2021,3,0,3,85,0,85,755917,13499,85
7/5/2021,5,0,5,312,0,312,756229,13504,312
7/6/2021,4,0,4,453,0,453,756682,13508,453
7/7/2021,6,0,6,406,0,406,757088,13514,406
7/8/2021,2,0,2,415,0,415,757503,13516,416
7/9/2021,4,0,4,392,0,392,757895,13520,391
7/10/2021,8,0,8,260,0,260,758155,13528,260
7/11/2021,3,0,3,260,0,260,758415,13531,260
7/12/2021,6,0,6,696,0,696,759111,13537,696
7/13/2021,2,0,2,545,0,545,759656,13539,545
7/14/2021,1,0,1,536,0,536,760192,13540,536
7/15/2021,4,0,4,585,0,585,760777,13544,585
7/16/2021,2,0,2,550,0,550,761327,13546,550
7/17/2021,5,0,5,374,0,374,761701,13551,374
7/18/2021,1,0,1,444,0,444,762145,13552,444
7/19/2021,0,0,0,866,0,866,763011,13552,866
7/20/2021,2,0,2,818,0,818,763829,13554,818
7/21/2021,6,0,6,851,0,851,764680,13560,851
7/22/2021,3,0,3,925,0,925,765605,13563,925
7/23/2021,5,0,5,799,0,799,766404,13568,799
7/24/2021,7,0,7,604,0,604,767008,13575,604
7/25/2021,5,0,5,715,0,715,767723,13580,715
7/26/2021,5,0,5,1394,0,1394,769117,13585,1394
7/27/2021,9,0,9,1206,0,1206,770323,13594,1206
7/28/2021,6,0,6,1358,0,1358,771681,13600,1359
7/29/2021,9,0,9,1362,0,1362,773043,13609,1361
7/30/2021,5,0,5,1260,0,1260,774303,13614,1260
7/31/2021,9,0,9,921,0,921,775224,13623,921
8/1/2021,9,0,9,981,0,981,776205,13632,981
8/2/2021,13,0,13,2156,0,2156,778361,13645,2156
8/3/2021,8,0,8,1955,0,1955,780316,13653,1955
8/4/2021,6,0,6,2002,0,2002,782318,13659,2002
8/5/2021,8,0,8,2205,0,2205,784523,13667,2205
8/6/2021,13,0,13,2095,0,2095,786618,13680,2095
8/7/2021,8,0,8,1434,0,1434,788052,13688,1434
8/8/2021,18,0,18,1355,0,1355,789407,13706,1355
8/9/2021,15,0,15,3260,0,3260,792667,13721,3260
8/10/2021,17,0,17,3019,0,3019,795686,13738,3020
8/11/2021,11,0,11,2809,0,2809,798495,13749,2808
8/12/2021,12,0,12,3071,0,3071,801566,13761,3071
8/13/2021,13,0,13,2733,0,2733,804299,13774,2734
8/14/2021,11,0,11,1769,0,1769,806068,13785,1768
8/15/2021,21,0,21,1617,0,1617,807685,13806,1617
8/16/2021,18,0,18,4549,0,4549,812234,13824,4549
8/17/2021,19,0,19,4050,0,4050,816284,13843,4050
8/18/2021,14,0,14,4123,0,4123,820407,13857,4124
8/19/2021,24,0,24,3993,0,3993,824400,13881,3992
8/20/2021,19,0,19,3788,0,3788,828188,13900,3788
8/21/2021,34,0,34,2316,0,2316,830504,13934,2316
8/22/2021,25,0,25,2040,0,2040,832544,13959,2040
8/23/2021,24,0,24,5663,0,5663,838207,13983,5663
8/24/2021,17,0,17,5167,0,5167,843374,14000,5167
8/25/2021,29,0,29,4774,0,4774,848148,14029,4774
8/26/2021,24,0,24,4756,0,4756,852904,14053,4756
8/27/2021,32,0,32,4455,0,4455,857359,14085,4455
8/28/2021,25,0,25,2571,0,2571,859930,14110,2571
8/29/2021,38,0,38,2098,0,2098,862028,14148,2099
8/30/2021,27,0,27,5944,0,5944,867972,14175,5943
8/31/2021,24,0,24,5159,0,5159,873131,14199,5159
9/1/2021,37,0,37,4996,0,4996,878127,14236,4996
9/2/2021,23,0,23,4492,0,4492,882619,14259,4493
9/3/2021,31,0,31,4326,0,4326,886945,14290,4326
9/4/2021,22,0,22,2509,0,2509,889454,14312,2508
9/5/2021,37,0,37,2111,0,2111,891565,14349,2111
9/6/2021,42,0,42,1775,0,1775,893340,14391,1776
9/7/2021,39,0,39,6668,0,6668,900008,14430,6667
9/8/2021,33,0,33,5244,0,5244,905252,14463,5244
9/9/2021,38,0,38,4707,0,4707,909959,14501,4708
9/10/2021,49,0,49,4109,0,4109,914068,14550,4108
9/11/2021,38,0,38,2447,0,2447,916515,14588,2448
9/12/2021,41,0,41,2039,0,2039,918554,14629,2039
9/13/2021,44,0,44,4972,0,4972,923526,14673,4971
9/14/2021,51,0,51,4396,0,4396,927922,14724,4396
9/15/2021,50,0,50,3785,0,3785,931707,14774,3786
9/16/2021,35,0,35,3533,0,3533,935240,14809,3532
9/17/2021,49,0,49,3394,0,3394,938634,14858,3394
9/18/2021,31,0,31,1964,0,1964,940598,14889,1964
9/19/2021,39,0,39,1557,0,1557,942155,14928,1557
9/20/2021,39,0,39,4162,0,4162,946317,14967,4162
9/21/2021,41,0,41,3431,0,3431,949748,15008,3431
9/22/2021,40,0,40,3064,0,3064,952812,15048,3064
9/23/2021,49,0,49,2869,0,2869,955681,15097,2869
9/24/2021,48,0,48,2540,0,2540,958221,15145,2540
9/25/2021,42,0,42,1554,0,1554,959775,15187,1554
9/26/2021,43,0,43,1388,0,1388,961163,15230,1388
9/27/2021,46,0,46,3828,0,3828,964991,15276,3828
9/28/2021,44,0,44,3001,0,3001,967992,15320,3001
9/29/2021,32,0,32,2936,0,2936,970928,15352,2936
9/30/2021,35,0,35,2697,0,2697,973625,15387,2697
10/1/2021,40,0,40,2454,0,2454,976079,15427,2454
10/2/2021,30,0,30,1460,0,1460,977539,15457,1460
10/3/2021,49,0,49,1294,0,1294,978833,15506,1294
10/4/2021,42,0,42,3293,0,3293,982126,15548,3293
10/5/2021,36,0,36,2741,0,2741,984867,15584,2741
10/6/2021,35,0,35,2570,0,2570,987437,15619,2570
10/7/2021,30,0,30,2362,0,2362,989799,15649,2363
10/8/2021,28,0,28,2086,0,2086,991885,15677,2085
10/9/2021,28,0,28,1263,0,1263,993148,15705,1263
10/10/2021,32,0,32,1069,0,1069,994217,15737,1069
10/11/2021,32,0,32,2741,0,2741,996958,15769,2743
10/12/2021,36,0,36,2374,0,2374,999332,15805,2372
10/13/2021,26,0,26,2047,0,2047,1001379,15831,2047
10/14/2021,38,0,38,1871,0,1871,1003250,15869,1871
10/15/2021,29,0,29,1648,0,1648,1004898,15898,1648
10/16/2021,31,0,31,1016,0,1016,1005914,15929,1016
10/17/2021,27,0,27,858,0,858,1006772,15956,858
10/18/2021,28,0,28,2257,0,2257,1009029,15984,2257
10/19/2021,34,0,34,1936,0,1936,1010965,16018,1936
10/20/2021,33,0,33,1853,0,1853,1012818,16051,1853
10/21/2021,28,0,28,1645,0,1645,1014463,16079,1645
10/22/2021,34,0,34,1463,0,1463,1015926,16113,1463
10/23/2021,26,0,26,961,0,961,1016887,16139,961
10/24/2021,29,0,29,858,0,858,1017745,16168,858
10/25/2021,22,0,22,2246,0,2246,1019991,16190,2246
10/26/2021,33,0,33,2009,0,2009,1022000,16223,2009
10/27/2021,24,0,24,1882,0,1882,1023882,16247,1882
10/28/2021,24,0,24,1715,0,1715,1025597,16271,1715
10/29/2021,24,0,24,1767,0,1767,1027364,16295,1767
10/30/2021,26,0,26,1094,0,1094,1028458,16321,1094
10/31/2021,24,0,24,839,0,839,1029297,16345,839
11/1/2021,26,0,26,2522,0,2522,1031819,16371,2522
11/2/2021,26,0,26,2181,0,2181,1034000,16397,2181
11/3/2021,25,0,25,2185,0,2185,1036185,16422,2185
11/4/2021,18,0,18,2161,0,2161,1038346,16440,2161
11/5/2021,28,0,28,2114,0,2114,1040460,16468,2114
11/6/2021,32,0,32,1312,0,1312,1041772,16500,1312
11/7/2021,25,0,25,1252,0,1252,1043024,16525,1252
11/8/2021,23,0,23,3392,0,3392,1046416,16548,3392
11/9/2021,23,0,23,2934,0,2934,1049350,16571,2935
11/10/2021,26,0,26,2946,0,2946,1052296,16597,2945
11/11/2021,33,0,33,2686,0,2686,1054982,16630,2686
11/12/2021,29,0,29,2882,0,2882,1057864,16659,2882
11/13/2021,23,0,23,1683,0,1683,1059547,16682,1683
11/14/2021,25,0,25,1546,0,1546,1061093,16707,1546
11/15/2021,30,0,30,4160,0,4160,1065253,16737,4160
11/16/2021,31,0,31,3586,0,3586,1068839,16768,3586
11/17/2021,23,0,23,3839,0,3839,1072678,16791,3839
11/18/2021,30,0,30,3610,0,3610,1076288,16821,3610
11/19/2021,35,0,35,3377,0,3377,1079665,16856,3377
11/20/2021,22,0,22,2089,0,2089,1081754,16878,2089
11/21/2021,31,0,31,1876,0,1876,1083630,16909,1876
11/22/2021,27,0,27,4575,0,4575,1088205,16936,4575
11/23/2021,23,0,23,4004,0,4004,1092209,16959,4004
11/24/2021,39,0,39,3596,0,3596,1095805,16998,3596
11/25/2021,37,0,37,689,0,689,1096494,17035,689
11/26/2021,30,0,30,3115,0,3115,1099609,17065,3115
11/27/2021,49,0,49,2512,0,2512,1102121,17114,2512
11/28/2021,36,0,36,2413,0,2413,1104534,17150,2413
11/29/2021,37,0,37,7049,0,7049,1111583,17187,7049
11/30/2021,34,0,34,5896,0,5896,1117479,17221,5896
12/1/2021,45,0,45,5746,0,5746,1123225,17266,5746
12/2/2021,39,0,39,5453,0,5453,1128678,17305,5453
12/3/2021,48,0,48,4836,0,4836,1133514,17353,4836
12/4/2021,34,0,34,2927,0,2927,1136441,17387,2928
12/5/2021,46,0,46,2300,0,2300,1138741,17433,2299
12/6/2021,49,0,49,6461,0,6461,1145202,17482,6461
12/7/2021,56,0,56,5462,0,5462,1150664,17538,5462
12/8/2021,49,0,49,5289,0,5289,1155953,17587,5289
12/9/2021,61,0,61,4893,0,4893,1160846,17648,4893
12/10/2021,51,0,51,4374,0,4374,1165220,17699,4374
12/11/2021,52,0,52,2533,0,2533,1167753,17751,2533
12/12/2021,43,0,43,2209,0,2209,1169962,17794,2209
12/13/2021,44,0,44,6087,0,6087,1176049,17838,6087
12/14/2021,69,0,69,5323,0,5323,1181372,17907,5323
12/15/2021,61,0,61,4979,0,4979,1186351,17968,4979
12/16/2021,64,0,64,4793,0,4793,1191144,18032,4793
12/17/2021,55,0,55,4269,0,4269,1195413,18087,4270
12/18/2021,58,0,58,2657,0,2657,1198070,18145,2656
12/19/2021,65,0,65,2209,0,2209,1200279,18210,2209
12/20/2021,49,0,49,6059,0,6059,1206338,18259,6059
12/21/2021,70,0,70,5910,0,5910,1212248,18329,5910
12/22/2021,69,0,69,6472,0,6472,1218720,18398,6473
12/23/2021,63,0,63,6062,0,6062,1224782,18461,6061
12/24/2021,55,0,55,3039,0,3039,1227821,18516,3039
12/25/2021,66,0,66,1406,0,1406,1229227,18582,1407
12/26/2021,57,0,57,3938,0,3938,1233165,18639,3937
12/27/2021,66,0,66,11739,0,11739,1244904,18705,11740
12/28/2021,59,0,59,12683,0,12683,1257587,18764,12682
12/29/2021,76,0,76,13160,0,13160,1270747,18840,13160
12/30/2021,68,0,68,11995,0,11995,1282742,18908,11995
12/31/2021,63,0,63,6197,0,6197,1288939,18971,6197
1/1/2022,57,0,57,3053,0,3053,1291992,19028,3053
1/2/2022,56,0,56,5756,0,5756,1297748,19084,5756
1/3/2022,73,0,73,16466,0,16466,1314214,19157,16468
1/4/2022,59,0,59,18570,0,18570,1332784,19216,18568
1/5/2022,51,0,51,17544,0,17544,1350328,19267,17545
1/6/2022,59,0,59,15941,0,15941,1366269,19326,15942
1/7/2022,69,0,69,13853,0,13853,1380122,19395,13853
1/8/2022,71,0,71,8195,0,8195,1388317,19466,8193
1/9/2022,67,0,67,6115,0,6115,1394432,19533,6115
1/10/2022,70,0,70,18998,0,18998,1413430,19603,19000
1/11/2022,84,0,84,18524,0,18524,1431954,19687,18523
1/12/2022,81,0,81,18213,0,18213,1450167,19768,18212
1/13/2022,85,0,85,17209,0,17209,1467376,19853,17209
1/14/2022,76,0,76,15080,0,15080,1482456,19929,15080
1/15/2022,74,0,74,7767,0,7767,1490223,20003,7768
1/16/2022,82,0,82,5702,0,5702,1495925,20085,5701
1/17/2022,73,0,73,14921,0,14921,1510846,20158,14921
1/18/2022,66,0,66,18038,0,18038,1528884,20224,18038
1/19/2022,86,0,86,17257,0,17257,1546141,20310,17257
1/20/2022,76,0,76,14831,0,14831,1560972,20386,14831
1/21/2022,82,0,82,12665,0,12665,1573637,20468,12665
1/22/2022,52,0,52,5972,0,5972,1579609,20520,5972
1/23/2022,73,0,73,4103,0,4103,1583712,20593,4103
1/24/2022,68,0,68,12591,0,12591,1596303,20661,12591
1/25/2022,57,0,57,10867,0,10867,1607170,20718,10867
1/26/2022,62,0,62,9733,0,9733,1616903,20780,9735
1/27/2022,72,0,72,8739,0,8739,1625642,20852,8737
1/28/2022,62,0,62,6654,0,6654,1632296,20914,6654
1/29/2022,78,0,78,3373,0,3373,1635669,20992,3374
1/30/2022,65,0,65,2678,0,2678,1638347,21057,2677
1/31/2022,57,0,57,7264,0,7264,1645611,21114,7266
2/1/2022,53,0,53,5517,0,5517,1651128,21167,5515
2/2/2022,58,0,58,3448,0,3448,1654576,21225,3448
2/3/2022,53,0,53,1093,0,1093,1655669,21278,1093
2/4/2022,54,0,54,2178,0,2178,1657847,21332,2178
2/5/2022,65,0,65,2020,0,2020,1659867,21397,2020
2/6/2022,41,0,41,1558,0,1558,1661425,21438,1558
2/7/2022,43,0,43,3803,0,3803,1665228,21481,3803
2/8/2022,56,0,56,2512,0,2512,1667740,21537,2512
2/9/2022,52,0,52,2231,0,2231,1669971,21589,2232
2/10/2022,46,0,46,1926,0,1926,1671897,21635,1925
2/11/2022,40,0,40,1560,0,1560,1673457,21675,1560
2/12/2022,54,0,54,784,0,784,1674241,21729,784
2/13/2022,57,0,57,646,0,646,1674887,21786,646
2/14/2022,43,0,43,1589,0,1589,1676476,21829,1589
2/15/2022,43,0,43,1290,0,1290,1677766,21872,1291
2/16/2022,33,0,33,1323,0,1323,1679089,21905,1322
2/17/2022,49,0,49,1005,0,1005,1680094,21954,1005
2/18/2022,37,0,37,818,0,818,1680912,21991,818
2/19/2022,36,0,36,474,0,474,1681386,22027,474
2/20/2022,28,0,28,429,0,429,1681815,22055,429
2/21/2022,29,0,29,934,0,934,1682749,22084,934
2/22/2022,35,0,35,790,0,790,1683539,22119,790
2/23/2022,25,0,25,685,0,685,1684224,22144,685
2/24/2022,21,0,21,618,0,618,1684842,22165,618
2/25/2022,29,0,29,566,0,566,1685408,22194,566
2/26/2022,15,0,15,275,0,275,1685683,22209,275
2/27/2022,20,0,20,211,0,211,1685894,22229,211
2/28/2022,21,0,21,509,0,509,1686403,22250,509
3/1/2022,23,0,23,429,0,429,1686832,22273,429
3/2/2022,18,0,18,401,0,401,1687233,22291,401
3/3/2022,16,0,16,411,0,411,1687644,22307,411
3/4/2022,20,0,20,349,0,349,1687993,22327,349
3/5/2022,10,0,10,195,0,195,1688188,22337,195
3/6/2022,18,0,18,168,0,168,1688356,22355,168
3/7/2022,12,0,12,428,0,428,1688784,22367,428
3/8/2022,16,0,16,325,0,325,1689109,22383,325
3/9/2022,19,0,19,277,0,277,1689386,22402,277
3/10/2022,20,0,20,294,0,294,1689680,22422,294
3/11/2022,13,0,13,239,0,239,1689919,22435,239
3/12/2022,16,0,16,136,0,136,1690055,22451,136
3/13/2022,14,0,14,124,0,124,1690179,22465,124
3/14/2022,8,0,8,300,0,300,1690479,22473,300
3/15/2022,10,0,10,256,0,256,1690735,22483,256
3/16/2022,8,0,8,236,0,236,1690971,22491,236
3/17/2022,7,0,7,202,0,202,1691173,22498,202
3/18/2022,8,0,8,224,0,224,1691397,22506,224
3/19/2022,8,0,8,151,0,151,1691548,22514,151
3/20/2022,10,0,10,118,0,118,1691666,22524,118
3/21/2022,6,0,6,271,0,271,1691937,22530,271
3/22/2022,11,0,11,219,0,219,1692156,22541,219
3/23/2022,5,0,5,209,0,209,1692365,22546,209
3/24/2022,6,0,6,239,0,239,1692604,22552,239
3/25/2022,10,0,10,203,0,203,1692807,22562,203
3/26/2022,6,0,6,130,0,130,1692937,22568,130
3/27/2022,5,0,5,123,0,123,1693060,22573,123
3/28/2022,4,0,4,216,0,216,1693276,22577,216
3/29/2022,5,0,5,206,0,206,1693482,22582,206
3/30/2022,11,NULL,NULL,222,NULL,NULL,1693704,22593,222
3/31/2022,7,NULL,NULL,188,NULL,NULL,1693892,22600,188
4/1/2022,2,NULL,NULL,187,NULL,NULL,1694079,22602,187
4/2/2022,5,NULL,NULL,128,NULL,NULL,1694207,22607,128
4/3/2022,2,NULL,NULL,115,NULL,NULL,1694322,22609,115
4/4/2022,4,NULL,NULL,257,NULL,NULL,1694579,22613,257
4/5/2022,5,NULL,NULL,238,NULL,NULL,1694817,22618,238
4/6/2022,2,NULL,NULL,251,NULL,NULL,1695068,22620,251
4/7/2022,4,NULL,NULL,221,NULL,NULL,1695289,22624,221
4/8/2022,4,NULL,NULL,189,NULL,NULL,1695478,22628,189
4/9/2022,4,NULL,NULL,122,NULL,NULL,1695600,22632,122
4/10/2022,7,NULL,NULL,167,NULL,NULL,1695767,22639,167
4/11/2022,3,NULL,NULL,353,NULL,NULL,1696120,22642,353
4/12/2022,4,NULL,NULL,360,NULL,NULL,1696480,22646,360
4/13/2022,6,NULL,NULL,362,NULL,NULL,1696842,22652,362
4/14/2022,0,NULL,NULL,379,NULL,NULL,1697221,22652,379
4/15/2022,2,NULL,NULL,333,NULL,NULL,1697554,22654,333
4/16/2022,3,NULL,NULL,264,NULL,NULL,1697818,22657,264
4/17/2022,0,NULL,NULL,180,NULL,NULL,1697998,22657,180
4/18/2022,2,NULL,NULL,554,NULL,NULL,1698552,22659,554
4/19/2022,6,NULL,NULL,487,NULL,NULL,1699039,22665,487
4/20/2022,7,NULL,NULL,551,NULL,NULL,1699590,22672,551
4/21/2022,7,NULL,NULL,612,NULL,NULL,1700202,22679,612
4/22/2022,2,NULL,NULL,504,NULL,NULL,1700706,22681,504
4/23/2022,5,NULL,NULL,394,NULL,NULL,1701100,22686,394
4/24/2022,1,NULL,NULL,356,NULL,NULL,1701456,22687,356
4/25/2022,4,NULL,NULL,769,NULL,NULL,1702225,22691,769
4/26/2022,6,NULL,NULL,727,NULL,NULL,1702952,22697,728
4/27/2022,4,NULL,NULL,776,NULL,NULL,1703728,22701,775
4/28/2022,7,NULL,NULL,645,NULL,NULL,1704373,22708,645
4/29/2022,1,NULL,NULL,641,NULL,NULL,1705014,22709,641
4/30/2022,5,NULL,NULL,469,NULL,NULL,1705483,22714,469
5/1/2022,3,NULL,NULL,444,NULL,NULL,1705927,22717,444
5/2/2022,6,NULL,NULL,972,NULL,NULL,1706899,22723,972
5/3/2022,1,NULL,NULL,1004,NULL,NULL,1707903,22724,1004
5/4/2022,5,NULL,NULL,951,NULL,NULL,1708854,22729,951
5/5/2022,1,NULL,NULL,1054,NULL,NULL,1709908,22730,1054
5/6/2022,3,NULL,NULL,983,NULL,NULL,1710891,22733,983
5/7/2022,1,NULL,NULL,625,NULL,NULL,1711516,22734,625
5/8/2022,4,NULL,NULL,599,NULL,NULL,1712115,22738,599
5/9/2022,5,NULL,NULL,1404,NULL,NULL,1713519,22743,1404
5/10/2022,2,NULL,NULL,1283,NULL,NULL,1714802,22745,1283
5/11/2022,6,NULL,NULL,1319,NULL,NULL,1716121,22751,1319
5/12/2022,6,NULL,NULL,1304,NULL,NULL,1717425,22757,1304
5/13/2022,4,NULL,NULL,1096,NULL,NULL,1718521,22761,1096
5/14/2022,4,NULL,NULL,691,NULL,NULL,1719212,22765,691
5/15/2022,4,NULL,NULL,712,NULL,NULL,1719924,22769,712
5/16/2022,6,NULL,NULL,1522,NULL,NULL,1721446,22775,1522
5/17/2022,3,NULL,NULL,1513,NULL,NULL,1722959,22778,1513
5/18/2022,5,NULL,NULL,1388,NULL,NULL,1724347,22783,1389
5/19/2022,2,NULL,NULL,1368,NULL,NULL,1725715,22785,1367
5/20/2022,5,NULL,NULL,1244,NULL,NULL,1726959,22790,1244
5/21/2022,3,NULL,NULL,809,NULL,NULL,1727768,22793,809
5/22/2022,2,NULL,NULL,844,NULL,NULL,1728612,22795,844
5/23/2022,5,NULL,NULL,1625,NULL,NULL,1730237,22800,1625
5/24/2022,4,NULL,NULL,1419,NULL,NULL,1731656,22804,1419
5/25/2022,8,NULL,NULL,1281,NULL,NULL,1732937,22812,1281
5/26/2022,3,NULL,NULL,1450,NULL,NULL,1734387,22815,1450
5/27/2022,2,NULL,NULL,1256,NULL,NULL,1735643,22817,1256
5/28/2022,5,NULL,NULL,836,NULL,NULL,1736479,22822,836
5/29/2022,5,NULL,NULL,752,NULL,NULL,1737231,22827,752
5/30/2022,4,NULL,NULL,662,NULL,NULL,1737893,22831,662
5/31/2022,2,NULL,NULL,2054,NULL,NULL,1739947,22833,2054
6/1/2022,6,NULL,NULL,1646,NULL,NULL,1741593,22839,1646
6/2/2022,8,NULL,NULL,1447,NULL,NULL,1743040,22847,1447
6/3/2022,2,NULL,NULL,1187,NULL,NULL,1744227,22849,1187
6/4/2022,4,NULL,NULL,764,NULL,NULL,1744991,22853,764
6/5/2022,4,NULL,NULL,848,NULL,NULL,1745839,22857,848
6/6/2022,4,NULL,NULL,1635,NULL,NULL,1747474,22861,1635
6/7/2022,5,NULL,NULL,1481,NULL,NULL,1748955,22866,1481
6/8/2022,7,NULL,NULL,1448,NULL,NULL,1750403,22873,1448
6/9/2022,9,NULL,NULL,1291,NULL,NULL,1751694,22882,1291
6/10/2022,6,NULL,NULL,1211,NULL,NULL,1752905,22888,1211
6/11/2022,2,NULL,NULL,751,NULL,NULL,1753656,22890,751
6/12/2022,3,NULL,NULL,773,NULL,NULL,1754429,22893,773
6/13/2022,3,NULL,NULL,1496,NULL,NULL,1755925,22896,1496
6/14/2022,1,NULL,NULL,1448,NULL,NULL,1757373,22897,1448
6/15/2022,7,NULL,NULL,1481,NULL,NULL,1758854,22904,1481
6/16/2022,8,NULL,NULL,1345,NULL,NULL,1760199,22912,1345
6/17/2022,3,NULL,NULL,1232,NULL,NULL,1761431,22915,1232
6/18/2022,4,NULL,NULL,795,NULL,NULL,1762226,22919,795
6/19/2022,7,NULL,NULL,780,NULL,NULL,1763006,22926,780
6/20/2022,5,NULL,NULL,1730,NULL,NULL,1764736,22931,1730
6/21/2022,8,NULL,NULL,1550,NULL,NULL,1766286,22939,1550
6/22/2022,4,NULL,NULL,1696,NULL,NULL,1767982,22943,1696
6/23/2022,2,NULL,NULL,1468,NULL,NULL,1769450,22945,1468
6/24/2022,5,NULL,NULL,1420,NULL,NULL,1770870,22950,1420
6/25/2022,8,NULL,NULL,989,NULL,NULL,1771859,22958,989
6/26/2022,4,NULL,NULL,932,NULL,NULL,1772791,22962,932
6/27/2022,8,NULL,NULL,2069,NULL,NULL,1774860,22970,2071
6/28/2022,9,NULL,NULL,1768,NULL,NULL,1776628,22979,1766
6/29/2022,9,NULL,NULL,1849,NULL,NULL,1778477,22988,1849
6/30/2022,6,NULL,NULL,1736,NULL,NULL,1780213,22994,1736
7/1/2022,5,NULL,NULL,1552,NULL,NULL,1781765,22999,1552
7/2/2022,7,NULL,NULL,1018,NULL,NULL,1782783,23006,1018
7/3/2022,1,NULL,NULL,1042,NULL,NULL,1783825,23007,1042
7/4/2022,7,NULL,NULL,750,NULL,NULL,1784575,23014,752
7/5/2022,3,NULL,NULL,2595,NULL,NULL,1787170,23017,2593
7/6/2022,7,NULL,NULL,2163,NULL,NULL,1789333,23024,2163
7/7/2022,11,NULL,NULL,2097,NULL,NULL,1791430,23035,2097
7/8/2022,5,NULL,NULL,1955,NULL,NULL,1793385,23040,1955
7/9/2022,6,NULL,NULL,1283,NULL,NULL,1794668,23046,1283
7/10/2022,6,NULL,NULL,1121,NULL,NULL,1795789,23052,1121
7/11/2022,10,NULL,NULL,2069,NULL,NULL,1797858,23062,2069
7/12/2022,4,NULL,NULL,2372,NULL,NULL,1800230,23066,2372
7/13/2022,13,NULL,NULL,2288,NULL,NULL,1802518,23079,2288
7/14/2022,10,NULL,NULL,2057,NULL,NULL,1804575,23089,2057
7/15/2022,7,NULL,NULL,1876,NULL,NULL,1806451,23096,1876
7/16/2022,6,NULL,NULL,1338,NULL,NULL,1807789,23102,1339
7/17/2022,10,NULL,NULL,1375,NULL,NULL,1809164,23112,1374
7/18/2022,14,NULL,NULL,2909,NULL,NULL,1812073,23126,2909
7/19/2022,6,NULL,NULL,2677,NULL,NULL,1814750,23132,2677
7/20/2022,6,NULL,NULL,2529,NULL,NULL,1817279,23138,2529
7/21/2022,9,NULL,NULL,2378,NULL,NULL,1819657,23147,2378
7/22/2022,11,NULL,NULL,2037,NULL,NULL,1821694,23158,2037
7/23/2022,6,NULL,NULL,1427,NULL,NULL,1823121,23164,1427
7/24/2022,5,NULL,NULL,1452,NULL,NULL,1824573,23169,1452
7/25/2022,9,NULL,NULL,3111,NULL,NULL,1827684,23178,3111
7/26/2022,10,NULL,NULL,2688,NULL,NULL,1830372,23188,2688
7/27/2022,8,NULL,NULL,1926,NULL,NULL,1832298,23196,1926
7/28/2022,6,NULL,NULL,2252,NULL,NULL,1834550,23202,2252
7/29/2022,5,NULL,NULL,2087,NULL,NULL,1836637,23207,2087
7/30/2022,10,NULL,NULL,1399,NULL,NULL,1838036,23217,1399
7/31/2022,17,NULL,NULL,1466,NULL,NULL,1839502,23234,1466
8/1/2022,10,NULL,NULL,2989,NULL,NULL,1842491,23244,2989
8/2/2022,12,NULL,NULL,2573,NULL,NULL,1845064,23256,2573
8/3/2022,8,NULL,NULL,2511,NULL,NULL,1847575,23264,2511
8/4/2022,12,NULL,NULL,2205,NULL,NULL,1849780,23276,2205
8/5/2022,11,NULL,NULL,2122,NULL,NULL,1851902,23287,2122
8/6/2022,8,NULL,NULL,1397,NULL,NULL,1853299,23295,1397
8/7/2022,7,NULL,NULL,1320,NULL,NULL,1854619,23302,1320
8/8/2022,10,NULL,NULL,3020,NULL,NULL,1857639,23312,3020
8/9/2022,12,NULL,NULL,2552,NULL,NULL,1860191,23324,2553
8/10/2022,8,NULL,NULL,2415,NULL,NULL,1862606,23332,2414
8/11/2022,4,NULL,NULL,2262,NULL,NULL,1864868,23336,2262
8/12/2022,9,NULL,NULL,1795,NULL,NULL,1866663,23345,1795
8/13/2022,6,NULL,NULL,1224,NULL,NULL,1867887,23351,1224
8/14/2022,15,NULL,NULL,1361,NULL,NULL,1869248,23366,1361
8/15/2022,5,NULL,NULL,2776,NULL,NULL,1872024,23371,2777
8/16/2022,10,NULL,NULL,2648,NULL,NULL,1874672,23381,2647
8/17/2022,7,NULL,NULL,2656,NULL,NULL,1877328,23388,2656
8/18/2022,10,NULL,NULL,2231,NULL,NULL,1879559,23398,2231
8/19/2022,11,NULL,NULL,2069,NULL,NULL,1881628,23409,2069
8/20/2022,17,NULL,NULL,1215,NULL,NULL,1882843,23426,1215
8/21/2022,7,NULL,NULL,1432,NULL,NULL,1884275,23433,1433
8/22/2022,12,NULL,NULL,3034,NULL,NULL,1887309,23445,3033
8/23/2022,13,NULL,NULL,2536,NULL,NULL,1889845,23458,2536
8/24/2022,10,NULL,NULL,2314,NULL,NULL,1892159,23468,2314
8/25/2022,9,NULL,NULL,2048,NULL,NULL,1894207,23477,2048
8/26/2022,9,NULL,NULL,1865,NULL,NULL,1896072,23486,1865
8/27/2022,7,NULL,NULL,1128,NULL,NULL,1897200,23493,1128
8/28/2022,12,NULL,NULL,1065,NULL,NULL,1898265,23505,1065
8/29/2022,11,NULL,NULL,2358,NULL,NULL,1900623,23516,2358
8/30/2022,10,NULL,NULL,1904,NULL,NULL,1902527,23526,1904
8/31/2022,8,NULL,NULL,1763,NULL,NULL,1904290,23534,1763
9/1/2022,5,NULL,NULL,1591,NULL,NULL,1905881,23539,1591
9/2/2022,12,NULL,NULL,1278,NULL,NULL,1907159,23551,1278
9/3/2022,6,NULL,NULL,783,NULL,NULL,1907942,23557,783
9/4/2022,17,NULL,NULL,707,NULL,NULL,1908649,23574,707
9/5/2022,8,NULL,NULL,663,NULL,NULL,1909312,23582,663
9/6/2022,9,NULL,NULL,1688,NULL,NULL,1911000,23591,1688
9/7/2022,6,NULL,NULL,1286,NULL,NULL,1912286,23597,1286
9/8/2022,6,NULL,NULL,1199,NULL,NULL,1913485,23603,1199
9/9/2022,5,NULL,NULL,972,NULL,NULL,1914457,23608,972
9/10/2022,8,NULL,NULL,527,NULL,NULL,1914984,23616,527
9/11/2022,8,NULL,NULL,480,NULL,NULL,1915464,23624,480
9/12/2022,9,NULL,NULL,1151,NULL,NULL,1916615,23633,1151
9/13/2022,9,NULL,NULL,923,NULL,NULL,1917538,23642,923
9/14/2022,7,NULL,NULL,926,NULL,NULL,1918464,23649,926
9/15/2022,4,NULL,NULL,759,NULL,NULL,1919223,23653,759
9/16/2022,6,NULL,NULL,724,NULL,NULL,1919947,23659,724
9/17/2022,8,NULL,NULL,408,NULL,NULL,1920355,23667,408
9/18/2022,10,NULL,NULL,439,NULL,NULL,1920794,23677,439
9/19/2022,11,NULL,NULL,972,NULL,NULL,1921766,23688,972
9/20/2022,7,NULL,NULL,809,NULL,NULL,1922575,23695,809
9/21/2022,7,NULL,NULL,744,NULL,NULL,1923319,23702,744
9/22/2022,11,NULL,NULL,658,NULL,NULL,1923977,23713,658
9/23/2022,2,NULL,NULL,569,NULL,NULL,1924546,23715,569
9/24/2022,7,NULL,NULL,343,NULL,NULL,1924889,23722,343
9/25/2022,5,NULL,NULL,318,NULL,NULL,1925207,23727,318
9/26/2022,6,NULL,NULL,792,NULL,NULL,1925999,23733,792
9/27/2022,3,NULL,NULL,654,NULL,NULL,1926653,23736,654
9/28/2022,8,NULL,NULL,646,NULL,NULL,1927299,23744,646
9/29/2022,4,NULL,NULL,593,NULL,NULL,1927892,23748,593
9/30/2022,9,NULL,NULL,511,NULL,NULL,1928403,23757,511
10/1/2022,8,NULL,NULL,402,NULL,NULL,1928805,23765,402
10/2/2022,9,NULL,NULL,370,NULL,NULL,1929175,23774,370
10/3/2022,4,NULL,NULL,856,NULL,NULL,1930031,23778,856
10/4/2022,7,NULL,NULL,667,NULL,NULL,1930698,23785,667
10/5/2022,8,NULL,NULL,668,NULL,NULL,1931366,23793,668
10/6/2022,5,NULL,NULL,555,NULL,NULL,1931921,23798,555
10/7/2022,4,NULL,NULL,454,NULL,NULL,1932375,23802,454
10/8/2022,5,NULL,NULL,331,NULL,NULL,1932706,23807,331
10/9/2022,4,NULL,NULL,276,NULL,NULL,1932982,23811,276
10/10/2022,3,NULL,NULL,663,NULL,NULL,1933645,23814,663
10/11/2022,7,NULL,NULL,830,NULL,NULL,1934475,23821,830
10/12/2022,6,NULL,NULL,714,NULL,NULL,1935189,23827,714
10/13/2022,5,NULL,NULL,674,NULL,NULL,1935863,23832,674
10/14/2022,10,NULL,NULL,634,NULL,NULL,1936497,23842,634
10/15/2022,4,NULL,NULL,334,NULL,NULL,1936831,23846,334
10/16/2022,4,NULL,NULL,374,NULL,NULL,1937205,23850,374
10/17/2022,4,NULL,NULL,745,NULL,NULL,1937950,23854,745
10/18/2022,5,NULL,NULL,657,NULL,NULL,1938607,23859,657
10/19/2022,8,NULL,NULL,701,NULL,NULL,1939308,23867,701
10/20/2022,6,NULL,NULL,587,NULL,NULL,1939895,23873,587
10/21/2022,12,NULL,NULL,773,NULL,NULL,1940668,23885,773
10/22/2022,10,NULL,NULL,493,NULL,NULL,1941161,23895,493
10/23/2022,9,NULL,NULL,517,NULL,NULL,1941678,23904,517
10/24/2022,6,NULL,NULL,1238,NULL,NULL,1942916,23910,1238
10/25/2022,2,NULL,NULL,1000,NULL,NULL,1943916,23912,1000
10/26/2022,8,NULL,NULL,955,NULL,NULL,1944871,23920,955
10/27/2022,8,NULL,NULL,836,NULL,NULL,1945707,23928,836
10/28/2022,7,NULL,NULL,642,NULL,NULL,1946349,23935,642
10/29/2022,8,NULL,NULL,407,NULL,NULL,1946756,23943,407
10/30/2022,10,NULL,NULL,458,NULL,NULL,1947214,23953,458
10/31/2022,6,NULL,NULL,1123,NULL,NULL,1948337,23959,1123
11/1/2022,5,NULL,NULL,965,NULL,NULL,1949302,23964,965
11/2/2022,11,NULL,NULL,987,NULL,NULL,1950289,23975,987
11/3/2022,6,NULL,NULL,898,NULL,NULL,1951187,23981,898
11/4/2022,9,NULL,NULL,842,NULL,NULL,1952029,23990,842
11/5/2022,5,NULL,NULL,505,NULL,NULL,1952534,23995,505
11/6/2022,9,NULL,NULL,507,NULL,NULL,1953041,24004,507
11/7/2022,9,NULL,NULL,989,NULL,NULL,1954030,24013,989
11/8/2022,7,NULL,NULL,921,NULL,NULL,1954951,24020,921
11/9/2022,6,NULL,NULL,785,NULL,NULL,1955736,24026,785
11/10/2022,6,NULL,NULL,854,NULL,NULL,1956590,24032,854
11/11/2022,10,NULL,NULL,723,NULL,NULL,1957313,24042,723
11/12/2022,7,NULL,NULL,462,NULL,NULL,1957775,24049,462
11/13/2022,6,NULL,NULL,456,NULL,NULL,1958231,24055,456
11/14/2022,2,NULL,NULL,1085,NULL,NULL,1959316,24057,1085
11/15/2022,6,NULL,NULL,961,NULL,NULL,1960277,24063,961
11/16/2022,7,NULL,NULL,967,NULL,NULL,1961244,24070,967
11/17/2022,9,NULL,NULL,972,NULL,NULL,1962216,24079,972
11/18/2022,9,NULL,NULL,833,NULL,NULL,1963049,24088,833
11/19/2022,6,NULL,NULL,603,NULL,NULL,1963652,24094,603
11/20/2022,5,NULL,NULL,620,NULL,NULL,1964272,24099,621
11/21/2022,5,NULL,NULL,1407,NULL,NULL,1965679,24104,1406
11/22/2022,6,NULL,NULL,1170,NULL,NULL,1966849,24110,1170
11/23/2022,3,NULL,NULL,1085,NULL,NULL,1967934,24113,1085
11/24/2022,5,NULL,NULL,421,NULL,NULL,1968355,24118,421
11/25/2022,7,NULL,NULL,1074,NULL,NULL,1969429,24125,1074
11/26/2022,9,NULL,NULL,870,NULL,NULL,1970299,24134,870
11/27/2022,5,NULL,NULL,1100,NULL,NULL,1971399,24139,1100
11/28/2022,8,NULL,NULL,1898,NULL,NULL,1973297,24147,1898
11/29/2022,9,NULL,NULL,1848,NULL,NULL,1975145,24156,1848
11/30/2022,3,NULL,NULL,1594,NULL,NULL,1976739,24159,1594
12/1/2022,15,NULL,NULL,1493,NULL,NULL,1978232,24174,1493
12/2/2022,10,NULL,NULL,1470,NULL,NULL,1979702,24184,1470
12/3/2022,4,NULL,NULL,795,NULL,NULL,1980497,24188,795
12/4/2022,10,NULL,NULL,813,NULL,NULL,1981310,24198,813
12/5/2022,8,NULL,NULL,1915,NULL,NULL,1983225,24206,1915
12/6/2022,8,NULL,NULL,1660,NULL,NULL,1984885,24214,1660
12/7/2022,15,NULL,NULL,1600,NULL,NULL,1986485,24229,1600
12/8/2022,12,NULL,NULL,1568,NULL,NULL,1988053,24241,1568
12/9/2022,11,NULL,NULL,1432,NULL,NULL,1989485,24252,1432
12/10/2022,13,NULL,NULL,880,NULL,NULL,1990365,24265,881
12/11/2022,10,NULL,NULL,958,NULL,NULL,1991323,24275,957
12/12/2022,11,NULL,NULL,1937,NULL,NULL,1993260,24286,1937
12/13/2022,15,NULL,NULL,1684,NULL,NULL,1994944,24301,1684
12/14/2022,11,NULL,NULL,1624,NULL,NULL,1996568,24312,1624
12/15/2022,13,NULL,NULL,1451,NULL,NULL,1998019,24325,1451
12/16/2022,11,NULL,NULL,1419,NULL,NULL,1999438,24336,1419
12/17/2022,10,NULL,NULL,908,NULL,NULL,2000346,24346,908
12/18/2022,9,NULL,NULL,810,NULL,NULL,2001156,24355,810
12/19/2022,13,NULL,NULL,1612,NULL,NULL,2002768,24368,1672
12/20/2022,22,NULL,NULL,1487,NULL,NULL,2004255,24390,1427
12/21/2022,14,NULL,NULL,1471,NULL,NULL,2005726,24404,1471
12/22/2022,11,NULL,NULL,981,NULL,NULL,2006707,24415,981
12/23/2022,16,NULL,NULL,594,NULL,NULL,2007301,24431,594
12/24/2022,9,NULL,NULL,552,NULL,NULL,2007853,24440,552
12/25/2022,14,NULL,NULL,393,NULL,NULL,2008246,24454,393
12/26/2022,14,NULL,NULL,1046,NULL,NULL,2009292,24468,1046
12/27/2022,10,NULL,NULL,1427,NULL,NULL,2010719,24478,1427
12/28/2022,19,NULL,NULL,1596,NULL,NULL,2012315,24497,1596
12/29/2022,15,NULL,NULL,1338,NULL,NULL,2013653,24512,1338
12/30/2022,9,NULL,NULL,1148,NULL,NULL,2014801,24521,1148
12/31/2022,12,NULL,NULL,607,NULL,NULL,2015408,24533,607
1/1/2023,13,NULL,NULL,480,NULL,NULL,2015888,24546,481
1/2/2023,9,NULL,NULL,994,NULL,NULL,2016882,24555,993
1/3/2023,16,NULL,NULL,1156,NULL,NULL,2018038,24571,1157
1/4/2023,16,NULL,NULL,1103,NULL,NULL,2019141,24587,1102
1/5/2023,10,NULL,NULL,934,NULL,NULL,2020075,24597,934
1/6/2023,17,NULL,NULL,810,NULL,NULL,2020885,24614,810
1/7/2023,17,NULL,NULL,462,NULL,NULL,2021347,24631,462
1/8/2023,12,NULL,NULL,449,NULL,NULL,2021796,24643,449
1/9/2023,6,NULL,NULL,904,NULL,NULL,2022700,24649,904
1/10/2023,12,NULL,NULL,863,NULL,NULL,2023563,24661,863
1/11/2023,6,NULL,NULL,766,NULL,NULL,2024329,24667,766
1/12/2023,8,NULL,NULL,680,NULL,NULL,2025009,24675,680
1/13/2023,11,NULL,NULL,621,NULL,NULL,2025630,24686,621
1/14/2023,10,NULL,NULL,362,NULL,NULL,2025992,24696,362
1/15/2023,7,NULL,NULL,375,NULL,NULL,2026367,24703,375
1/16/2023,8,NULL,NULL,647,NULL,NULL,2027014,24711,647
1/17/2023,12,NULL,NULL,703,NULL,NULL,2027717,24723,703
1/18/2023,4,NULL,NULL,792,NULL,NULL,2028509,24727,792
1/19/2023,12,NULL,NULL,657,NULL,NULL,2029166,24739,657
1/20/2023,6,NULL,NULL,635,NULL,NULL,2029801,24745,635
1/21/2023,3,NULL,NULL,303,NULL,NULL,2030104,24748,303
1/22/2023,9,NULL,NULL,286,NULL,NULL,2030390,24757,286
1/23/2023,6,NULL,NULL,744,NULL,NULL,2031134,24763,744
1/24/2023,6,NULL,NULL,710,NULL,NULL,2031844,24769,710
1/25/2023,8,NULL,NULL,596,NULL,NULL,2032440,24777,596
1/26/2023,3,NULL,NULL,730,NULL,NULL,2033170,24780,730
1/27/2023,9,NULL,NULL,592,NULL,NULL,2033762,24789,592
1/28/2023,8,NULL,NULL,406,NULL,NULL,2034168,24797,406
1/29/2023,7,NULL,NULL,422,NULL,NULL,2034590,24804,422
1/30/2023,4,NULL,NULL,804,NULL,NULL,2035394,24808,804
1/31/2023,6,NULL,NULL,705,NULL,NULL,2036099,24814,705
2/1/2023,4,NULL,NULL,690,NULL,NULL,2036789,24818,690
2/2/2023,11,NULL,NULL,702,NULL,NULL,2037491,24829,702
2/3/2023,7,NULL,NULL,612,NULL,NULL,2038103,24836,612
2/4/2023,5,NULL,NULL,387,NULL,NULL,2038490,24841,387
2/5/2023,2,NULL,NULL,396,NULL,NULL,2038886,24843,396
2/6/2023,5,NULL,NULL,945,NULL,NULL,2039831,24848,945
2/7/2023,10,NULL,NULL,862,NULL,NULL,2040693,24858,862
2/8/2023,2,NULL,NULL,901,NULL,NULL,2041594,24860,901
2/9/2023,7,NULL,NULL,779,NULL,NULL,2042373,24867,779
2/10/2023,5,NULL,NULL,719,NULL,NULL,2043092,24872,719
2/11/2023,5,NULL,NULL,457,NULL,NULL,2043549,24877,457
2/12/2023,6,NULL,NULL,450,NULL,NULL,2043999,24883,450
2/13/2023,3,NULL,NULL,920,NULL,NULL,2044919,24886,920
2/14/2023,6,NULL,NULL,784,NULL,NULL,2045703,24892,784
2/15/2023,6,NULL,NULL,781,NULL,NULL,2046484,24898,782
2/16/2023,8,NULL,NULL,721,NULL,NULL,2047205,24906,721
2/17/2023,4,NULL,NULL,611,NULL,NULL,2047816,24910,610
2/18/2023,5,NULL,NULL,360,NULL,NULL,2048176,24915,360
2/19/2023,4,NULL,NULL,412,NULL,NULL,2048588,24919,412
2/20/2023,7,NULL,NULL,779,NULL,NULL,2049367,24926,779
2/21/2023,4,NULL,NULL,769,NULL,NULL,2050136,24930,769
2/22/2023,7,NULL,NULL,799,NULL,NULL,2050935,24937,799
2/23/2023,6,NULL,NULL,767,NULL,NULL,2051702,24943,767
2/24/2023,4,NULL,NULL,673,NULL,NULL,2052375,24947,673
2/25/2023,3,NULL,NULL,409,NULL,NULL,2052784,24950,409
2/26/2023,1,NULL,NULL,386,NULL,NULL,2053170,24951,386
2/27/2023,4,NULL,NULL,843,NULL,NULL,2054013,24955,843
2/28/2023,6,NULL,NULL,666,NULL,NULL,2054679,24961,666
3/1/2023,5,NULL,NULL,661,NULL,NULL,2055340,24966,661
3/2/2023,4,NULL,NULL,574,NULL,NULL,2055914,24970,574
3/3/2023,8,NULL,NULL,542,NULL,NULL,2056456,24978,542
3/4/2023,6,NULL,NULL,310,NULL,NULL,2056766,24984,310
3/5/2023,2,NULL,NULL,350,NULL,NULL,2057116,24986,350
3/6/2023,8,NULL,NULL,689,NULL,NULL,2057805,24994,689
3/7/2023,6,NULL,NULL,562,NULL,NULL,2058367,25000,562
3/8/2023,5,NULL,NULL,558,NULL,NULL,2058925,25005,558
3/9/2023,7,NULL,NULL,431,NULL,NULL,2059356,25012,431
3/10/2023,4,NULL,NULL,478,NULL,NULL,2059834,25016,478
3/11/2023,5,NULL,NULL,304,NULL,NULL,2060138,25021,304
3/12/2023,14,NULL,NULL,307,NULL,NULL,2060445,25035,307
3/13/2023,9,NULL,NULL,626,NULL,NULL,2061071,25044,626
3/14/2023,3,NULL,NULL,519,NULL,NULL,2061590,25047,519
3/15/2023,8,NULL,NULL,536,NULL,NULL,2062126,25055,536
3/16/2023,3,NULL,NULL,467,NULL,NULL,2062593,25058,467
3/17/2023,5,NULL,NULL,429,NULL,NULL,2063022,25063,429
3/18/2023,4,NULL,NULL,227,NULL,NULL,2063249,25067,227
3/19/2023,5,NULL,NULL,261,NULL,NULL,2063510,25072,261
3/20/2023,5,NULL,NULL,516,NULL,NULL,2064026,25077,516
3/21/2023,4,NULL,NULL,547,NULL,NULL,2064573,25081,547
3/22/2023,12,NULL,NULL,504,NULL,NULL,2065077,25093,504
3/23/2023,4,NULL,NULL,497,NULL,NULL,2065574,25097,497
3/24/2023,5,NULL,NULL,398,NULL,NULL,2065972,25102,398
3/25/2023,0,NULL,NULL,268,NULL,NULL,2066240,25102,268
3/26/2023,5,NULL,NULL,252,NULL,NULL,2066492,25107,252
3/27/2023,6,NULL,NULL,425,NULL,NULL,2066917,25113,425
3/28/2023,4,NULL,NULL,378,NULL,NULL,2067295,25117,378
3/29/2023,5,NULL,NULL,455,NULL,NULL,2067750,25122,455
3/30/2023,4,NULL,NULL,400,NULL,NULL,2068150,25126,400
3/31/2023,4,NULL,NULL,290,NULL,NULL,2068440,25130,290
4/1/2023,3,NULL,NULL,201,NULL,NULL,2068641,25133,201
4/2/2023,4,NULL,NULL,224,NULL,NULL,2068865,25137,224
4/3/2023,5,NULL,NULL,385,NULL,NULL,2069250,25142,385
4/4/2023,1,NULL,NULL,392,NULL,NULL,2069642,25143,392
4/5/2023,3,NULL,NULL,311,NULL,NULL,2069953,25146,311
4/6/2023,2,NULL,NULL,348,NULL,NULL,2070301,25148,348
4/7/2023,3,NULL,NULL,259,NULL,NULL,2070560,25151,259
4/8/2023,4,NULL,NULL,155,NULL,NULL,2070715,25155,155
4/9/2023,6,NULL,NULL,125,NULL,NULL,2070840,25161,125
4/10/2023,4,NULL,NULL,377,NULL,NULL,2071217,25165,377
4/11/2023,4,NULL,NULL,347,NULL,NULL,2071564,25169,347
4/12/2023,3,NULL,NULL,283,NULL,NULL,2071847,25172,283
4/13/2023,3,NULL,NULL,331,NULL,NULL,2072178,25175,331
4/14/2023,0,NULL,NULL,273,NULL,NULL,2072451,25175,273
4/15/2023,2,NULL,NULL,175,NULL,NULL,2072626,25177,175
4/16/2023,5,NULL,NULL,127,NULL,NULL,2072753,25182,127
4/17/2023,5,NULL,NULL,336,NULL,NULL,2073089,25187,336
4/18/2023,6,NULL,NULL,221,NULL,NULL,2073310,25193,221
4/19/2023,3,NULL,NULL,220,NULL,NULL,2073530,25196,220
4/20/2023,4,NULL,NULL,212,NULL,NULL,2073742,25200,212
4/21/2023,7,NULL,NULL,199,NULL,NULL,2073941,25207,199
4/22/2023,1,NULL,NULL,110,NULL,NULL,2074051,25208,110
4/23/2023,3,NULL,NULL,145,NULL,NULL,2074196,25211,145
4/24/2023,2,NULL,NULL,280,NULL,NULL,2074476,25213,280
4/25/2023,1,NULL,NULL,231,NULL,NULL,2074707,25214,231
4/26/2023,1,NULL,NULL,219,NULL,NULL,2074926,25215,219
4/27/2023,3,NULL,NULL,210,NULL,NULL,2075136,25218,210
4/28/2023,5,NULL,NULL,203,NULL,NULL,2075339,25223,203
4/29/2023,2,NULL,NULL,120,NULL,NULL,2075459,25225,120
4/30/2023,0,NULL,NULL,141,NULL,NULL,2075600,25225,141
5/1/2023,5,NULL,NULL,291,NULL,NULL,2075891,25230,291
5/2/2023,4,NULL,NULL,222,NULL,NULL,2076113,25234,222
5/3/2023,2,NULL,NULL,212,NULL,NULL,2076325,25236,212
5/4/2023,5,NULL,NULL,217,NULL,NULL,2076542,25241,217
5/5/2023,0,NULL,NULL,196,NULL,NULL,2076738,25241,196
5/6/2023,0,NULL,NULL,116,NULL,NULL,2076854,25241,116
5/7/2023,1,NULL,NULL,145,NULL,NULL,2076999,25242,145
5/8/2023,3,NULL,NULL,239,NULL,NULL,2077238,25245,239
5/9/2023,3,NULL,NULL,218,NULL,NULL,2077456,25248,218
5/10/2023,0,NULL,NULL,225,NULL,NULL,2077681,25248,225
5/11/2023,2,NULL,NULL,156,NULL,NULL,2077837,25250,156
5/12/2023,1,NULL,NULL,142,NULL,NULL,2077979,25251,142
5/13/2023,3,NULL,NULL,99,NULL,NULL,2078078,25254,99
5/14/2023,2,NULL,NULL,81,NULL,NULL,2078159,25256,81
5/15/2023,3,NULL,NULL,207,NULL,NULL,2078366,25259,207
5/16/2023,4,NULL,NULL,145,NULL,NULL,2078511,25263,145
5/17/2023,1,NULL,NULL,147,NULL,NULL,2078658,25264,147
5/18/2023,3,NULL,NULL,133,NULL,NULL,2078791,25267,133
5/19/2023,0,NULL,NULL,125,NULL,NULL,2078916,25267,125
5/20/2023,2,NULL,NULL,95,NULL,NULL,2079011,25269,95
5/21/2023,3,NULL,NULL,78,NULL,NULL,2079089,25272,78
5/22/2023,0,NULL,NULL,156,NULL,NULL,2079245,25272,156
5/23/2023,2,NULL,NULL,139,NULL,NULL,2079384,25274,139
5/24/2023,0,NULL,NULL,103,NULL,NULL,2079487,25274,103
5/25/2023,1,NULL,NULL,109,NULL,NULL,2079596,25275,109
5/26/2023,0,NULL,NULL,97,NULL,NULL,2079693,25275,97
5/27/2023,1,NULL,NULL,75,NULL,NULL,2079768,25276,75
5/28/2023,1,NULL,NULL,72,NULL,NULL,2079840,25277,72
5/29/2023,1,NULL,NULL,99,NULL,NULL,2079939,25278,99
5/30/2023,1,NULL,NULL,150,NULL,NULL,2080089,25279,150
5/31/2023,3,NULL,NULL,160,NULL,NULL,2080249,25282,160
6/1/2023,3,NULL,NULL,119,NULL,NULL,2080368,25285,119
6/2/2023,2,NULL,NULL,88,NULL,NULL,2080456,25287,88
6/3/2023,1,NULL,NULL,51,NULL,NULL,2080507,25288,51
6/4/2023,2,NULL,NULL,56,NULL,NULL,2080563,25290,56
6/5/2023,1,NULL,NULL,114,NULL,NULL,2080677,25291,114
6/6/2023,3,NULL,NULL,84,NULL,NULL,2080761,25294,84
6/7/2023,5,NULL,NULL,92,NULL,NULL,2080853,25299,92
6/8/2023,2,NULL,NULL,78,NULL,NULL,2080931,25301,78
6/9/2023,1,NULL,NULL,82,NULL,NULL,2081013,25302,82
6/10/2023,1,NULL,NULL,64,NULL,NULL,2081077,25303,64
6/11/2023,6,NULL,NULL,45,NULL,NULL,2081122,25309,45
6/12/2023,4,NULL,NULL,82,NULL,NULL,2081204,25313,82
6/13/2023,1,NULL,NULL,91,NULL,NULL,2081295,25314,91
6/14/2023,0,NULL,NULL,78,NULL,NULL,2081373,25314,78
6/15/2023,0,NULL,NULL,83,NULL,NULL,2081456,25314,83
6/16/2023,1,NULL,NULL,96,NULL,NULL,2081552,25315,96
6/17/2023,1,NULL,NULL,48,NULL,NULL,2081600,25316,48
6/18/2023,1,NULL,NULL,75,NULL,NULL,2081675,25317,75
6/19/2023,1,NULL,NULL,99,NULL,NULL,2081774,25318,99
6/20/2023,2,NULL,NULL,108,NULL,NULL,2081882,25320,108
6/21/2023,1,NULL,NULL,87,NULL,NULL,2081969,25321,87
6/22/2023,3,NULL,NULL,78,NULL,NULL,2082047,25324,78
6/23/2023,1,NULL,NULL,70,NULL,NULL,2082117,25325,70
6/24/2023,0,NULL,NULL,44,NULL,NULL,2082161,25325,44
6/25/2023,0,NULL,NULL,39,NULL,NULL,2082200,25325,39
6/26/2023,3,NULL,NULL,119,NULL,NULL,2082319,25328,119
6/27/2023,0,NULL,NULL,95,NULL,NULL,2082414,25328,95
6/28/2023,2,NULL,NULL,96,NULL,NULL,2082510,25330,96
6/29/2023,2,NULL,NULL,85,NULL,NULL,2082595,25332,85
6/30/2023,0,NULL,NULL,77,NULL,NULL,2082672,25332,77
7/1/2023,0,NULL,NULL,38,NULL,NULL,2082710,25332,38
7/2/2023,0,NULL,NULL,56,NULL,NULL,2082766,25332,56
7/3/2023,1,NULL,NULL,83,NULL,NULL,2082849,25333,83
7/4/2023,2,NULL,NULL,54,NULL,NULL,2082903,25335,54
7/5/2023,1,NULL,NULL,96,NULL,NULL,2082999,25336,96
7/6/2023,3,NULL,NULL,97,NULL,NULL,2083096,25339,97
7/7/2023,1,NULL,NULL,84,NULL,NULL,2083180,25340,84
7/8/2023,0,NULL,NULL,68,NULL,NULL,2083248,25340,68
7/9/2023,1,NULL,NULL,64,NULL,NULL,2083312,25341,64
7/10/2023,1,NULL,NULL,126,NULL,NULL,2083438,25342,126
7/11/2023,0,NULL,NULL,99,NULL,NULL,2083537,25342,99
7/12/2023,0,NULL,NULL,134,NULL,NULL,2083671,25342,134
7/13/2023,2,NULL,NULL,119,NULL,NULL,2083790,25344,119
7/14/2023,0,NULL,NULL,109,NULL,NULL,2083899,25344,109
7/15/2023,1,NULL,NULL,70,NULL,NULL,2083969,25345,70
7/16/2023,0,NULL,NULL,77,NULL,NULL,2084046,25345,77
7/17/2023,1,NULL,NULL,135,NULL,NULL,2084181,25346,135
7/18/2023,0,NULL,NULL,119,NULL,NULL,2084300,25346,119
7/19/2023,1,NULL,NULL,146,NULL,NULL,2084446,25347,146
7/20/2023,1,NULL,NULL,120,NULL,NULL,2084566,25348,120
7/21/2023,0,NULL,NULL,132,NULL,NULL,2084698,25348,132
7/22/2023,1,NULL,NULL,85,NULL,NULL,2084783,25349,85
7/23/2023,2,NULL,NULL,94,NULL,NULL,2084877,25351,94
7/24/2023,1,NULL,NULL,187,NULL,NULL,2085064,25352,187
7/25/2023,1,NULL,NULL,161,NULL,NULL,2085225,25353,161
7/26/2023,2,NULL,NULL,208,NULL,NULL,2085433,25355,208
7/27/2023,0,NULL,NULL,158,NULL,NULL,2085591,25355,158
7/28/2023,1,NULL,NULL,173,NULL,NULL,2085764,25356,173
7/29/2023,1,NULL,NULL,111,NULL,NULL,2085875,25357,111
7/30/2023,0,NULL,NULL,120,NULL,NULL,2085995,25357,120
7/31/2023,1,NULL,NULL,227,NULL,NULL,2086222,25358,227
8/1/2023,2,NULL,NULL,193,NULL,NULL,2086415,25360,193
8/2/2023,1,NULL,NULL,396,NULL,NULL,2086811,25361,396
8/3/2023,0,NULL,NULL,308,NULL,NULL,2087119,25361,308
8/4/2023,0,NULL,NULL,288,NULL,NULL,2087407,25361,288
8/5/2023,1,NULL,NULL,172,NULL,NULL,2087579,25362,172
8/6/2023,1,NULL,NULL,168,NULL,NULL,2087747,25363,168
8/7/2023,1,NULL,NULL,343,NULL,NULL,2088090,25364,343
8/8/2023,0,NULL,NULL,358,NULL,NULL,2088448,25364,358
8/9/2023,1,NULL,NULL,350,NULL,NULL,2088798,25365,350
8/10/2023,0,NULL,NULL,378,NULL,NULL,2089176,25365,378
8/11/2023,1,NULL,NULL,323,NULL,NULL,2089499,25366,323
8/12/2023,0,NULL,NULL,227,NULL,NULL,2089726,25366,227
8/13/2023,0,NULL,NULL,239,NULL,NULL,2089965,25366,239
8/14/2023,4,NULL,NULL,496,NULL,NULL,2090461,25370,496
8/15/2023,1,NULL,NULL,536,NULL,NULL,2090997,25371,536
8/16/2023,2,NULL,NULL,486,NULL,NULL,2091483,25373,486
8/17/2023,3,NULL,NULL,492,NULL,NULL,2091975,25376,492
8/18/2023,2,NULL,NULL,482,NULL,NULL,2092457,25378,482
8/19/2023,2,NULL,NULL,327,NULL,NULL,2092784,25380,327
8/20/2023,0,NULL,NULL,343,NULL,NULL,2093127,25380,343
8/21/2023,1,NULL,NULL,662,NULL,NULL,2093789,25381,662
8/22/2023,3,NULL,NULL,545,NULL,NULL,2094334,25384,545
8/23/2023,1,NULL,NULL,590,NULL,NULL,2094924,25385,590
8/24/2023,1,NULL,NULL,839,NULL,NULL,2095763,25386,839
8/25/2023,4,NULL,NULL,636,NULL,NULL,2096399,25390,636
8/26/2023,2,NULL,NULL,378,NULL,NULL,2096777,25392,378
8/27/2023,2,NULL,NULL,370,NULL,NULL,2097147,25394,370
8/28/2023,2,NULL,NULL,800,NULL,NULL,2097947,25396,800
8/29/2023,2,NULL,NULL,811,NULL,NULL,2098758,25398,811
8/30/2023,5,NULL,NULL,715,NULL,NULL,2099473,25403,715
8/31/2023,4,NULL,NULL,657,NULL,NULL,2100130,25407,657
9/1/2023,3,NULL,NULL,486,NULL,NULL,2100616,25410,486
9/2/2023,0,NULL,NULL,296,NULL,NULL,2100912,25410,296
9/3/2023,4,NULL,NULL,383,NULL,NULL,2101295,25414,383
9/4/2023,3,NULL,NULL,541,NULL,NULL,2101836,25417,541
9/5/2023,4,NULL,NULL,673,NULL,NULL,2102509,25421,673
9/6/2023,2,NULL,NULL,611,NULL,NULL,2103120,25423,611
9/7/2023,4,NULL,NULL,568,NULL,NULL,2103688,25427,568
9/8/2023,3,NULL,NULL,514,NULL,NULL,2104202,25430,514
9/9/2023,1,NULL,NULL,261,NULL,NULL,2104463,25431,261
9/10/2023,3,NULL,NULL,288,NULL,NULL,2104751,25434,288
9/11/2023,0,NULL,NULL,551,NULL,NULL,2105302,25434,551
9/12/2023,5,NULL,NULL,493,NULL,NULL,2105795,25439,493
9/13/2023,5,NULL,NULL,489,NULL,NULL,2106284,25444,489
9/14/2023,4,NULL,NULL,427,NULL,NULL,2106711,25448,427
9/15/2023,2,NULL,NULL,371,NULL,NULL,2107082,25450,371
9/16/2023,5,NULL,NULL,256,NULL,NULL,2107338,25455,256
9/17/2023,2,NULL,NULL,263,NULL,NULL,2107601,25457,263
9/18/2023,3,NULL,NULL,458,NULL,NULL,2108059,25460,458
9/19/2023,2,NULL,NULL,455,NULL,NULL,2108514,25462,455
9/20/2023,4,NULL,NULL,419,NULL,NULL,2108933,25466,419
9/21/2023,5,NULL,NULL,417,NULL,NULL,2109350,25471,417
9/22/2023,6,NULL,NULL,378,NULL,NULL,2109728,25477,378
9/23/2023,4,NULL,NULL,243,NULL,NULL,2109971,25481,243
9/24/2023,5,NULL,NULL,248,NULL,NULL,2110219,25486,248
9/25/2023,5,NULL,NULL,484,NULL,NULL,2110703,25491,484
9/26/2023,1,NULL,NULL,405,NULL,NULL,2111108,25492,405
9/27/2023,10,NULL,NULL,437,NULL,NULL,2111545,25502,437
9/28/2023,4,NULL,NULL,401,NULL,NULL,2111946,25506,401
9/29/2023,3,NULL,NULL,337,NULL,NULL,2112283,25509,337
9/30/2023,1,NULL,NULL,215,NULL,NULL,2112498,25510,215
10/1/2023,6,NULL,NULL,215,NULL,NULL,2112713,25516,215
10/2/2023,4,NULL,NULL,425,NULL,NULL,2113138,25520,425
10/3/2023,1,NULL,NULL,395,NULL,NULL,2113533,25521,395
10/4/2023,5,NULL,NULL,405,NULL,NULL,2113938,25526,405
10/5/2023,6,NULL,NULL,336,NULL,NULL,2114274,25532,336
10/6/2023,1,NULL,NULL,289,NULL,NULL,2114563,25533,289
10/7/2023,7,NULL,NULL,183,NULL,NULL,2114746,25540,183
10/8/2023,3,NULL,NULL,180,NULL,NULL,2114926,25543,180
10/9/2023,3,NULL,NULL,360,NULL,NULL,2115286,25546,360
10/10/2023,4,NULL,NULL,380,NULL,NULL,2115666,25550,380
10/11/2023,4,NULL,NULL,368,NULL,NULL,2116034,25554,368
10/12/2023,0,NULL,NULL,389,NULL,NULL,2116423,25554,389
10/13/2023,2,NULL,NULL,376,NULL,NULL,2116799,25556,376
10/14/2023,3,NULL,NULL,230,NULL,NULL,2117029,25559,230
10/15/2023,3,NULL,NULL,252,NULL,NULL,2117281,25562,252
10/16/2023,4,NULL,NULL,451,NULL,NULL,2117732,25566,451
10/17/2023,3,NULL,NULL,499,NULL,NULL,2118231,25569,499
10/18/2023,0,NULL,NULL,419,NULL,NULL,2118650,25569,419
10/19/2023,1,NULL,NULL,450,NULL,NULL,2119100,25570,450
10/20/2023,1,NULL,NULL,432,NULL,NULL,2119532,25571,432
10/21/2023,3,NULL,NULL,230,NULL,NULL,2119762,25574,230
10/22/2023,5,NULL,NULL,243,NULL,NULL,2120005,25579,243
10/23/2023,2,NULL,NULL,445,NULL,NULL,2120450,25581,445
10/24/2023,7,NULL,NULL,434,NULL,NULL,2120884,25588,434
10/25/2023,1,NULL,NULL,536,NULL,NULL,2121420,25589,536
10/26/2023,4,NULL,NULL,482,NULL,NULL,2121902,25593,482
10/27/2023,5,NULL,NULL,442,NULL,NULL,2122344,25598,442
10/28/2023,2,NULL,NULL,267,NULL,NULL,2122611,25600,267
10/29/2023,3,NULL,NULL,272,NULL,NULL,2122883,25603,272
10/30/2023,3,NULL,NULL,429,NULL,NULL,2123312,25606,429
10/31/2023,5,NULL,NULL,436,NULL,NULL,2123748,25611,436
11/1/2023,6,NULL,NULL,504,NULL,NULL,2124252,25617,504
11/2/2023,1,NULL,NULL,512,NULL,NULL,2124764,25618,512
11/3/2023,4,NULL,NULL,455,NULL,NULL,2125219,25622,455
11/4/2023,2,NULL,NULL,292,NULL,NULL,2125511,25624,292
11/5/2023,6,NULL,NULL,334,NULL,NULL,2125845,25630,334
11/6/2023,5,NULL,NULL,672,NULL,NULL,2126517,25635,672
11/7/2023,6,NULL,NULL,652,NULL,NULL,2127169,25641,652
11/8/2023,4,NULL,NULL,692,NULL,NULL,2127861,25645,692
11/9/2023,6,NULL,NULL,634,NULL,NULL,2128495,25651,634
11/10/2023,1,NULL,NULL,353,NULL,NULL,2128848,25652,353
11/11/2023,1,NULL,NULL,237,NULL,NULL,2129085,25653,237
11/12/2023,0,NULL,NULL,248,NULL,NULL,2129333,25653,248
11/13/2023,1,NULL,NULL,492,NULL,NULL,2129825,25654,492
11/14/2023,0,NULL,NULL,299,NULL,NULL,2130124,25654,299
